`` pass me the salt , please . '' `` here you are . '' 	“ 请 把 盐 递给 我 。 ” “ 拿 着 。 ” 
he lives just around the corner . 	他 就 住 在 拐角 的 地方 。 
come on , trust me . 	来 吧 ， 相信 我 。 
the whole family was sick in bed . 	全家 都 病倒 了 。 
do n't speak to anyone . 	你们 别 和 任何人 说 。 
all sor@@ ts of people live in tokyo . 	各式各样 的 人 住 在 东京 。 
she is leaving for america tonight . 	她 今晚 离开 去 美国 。 
tom felt hungry . 	汤姆 觉得 饿 了 。 
he lives alone . 	他 独自 生活 。 
what 's your schedule for tomorrow ? 	你 明天 的 行程 安排 是 什么 ？ 
i think that fact is very important . 	我 认为 事实 非常 重要 。 
humor me . 	你 就 随 了 我 的 意 吧 。 
i am staying with a friend . 	我 和 一位 朋友 住 在 一起 。 
i have n't heard that story yet . 	我 还 没有 听过 那个 故事 。 
the road was wet from the rain . 	这条 路 因为 下雨 所以 是 湿 的 。 
are you here to see tom ? 	你 是 来 见 汤姆 的 吗 ？ 
who 's to blame for the accident ? 	谁 该 为 这次 事故 负责 ？ 
cities are exciting places , but also stre@@ ssful . 	城市 是 令人 兴奋 的 地方 ， 但 也 会 让 人 产生 压力 。 
there 's a pub just around the corner . 	在 转角 有 一家 酒吧 。 
how about another cup of coffee ? 	要 不要 再来 一杯 咖啡 ？ 
i love drinking tea . 	我 很 爱 喝茶 。 
watch yourself . 	自己 当心 啊 。 
i am an optimist by nature . 	我 天生 是 一个 乐观主义 者 。 
how long do you plan on staying ? 	你 准备 待 多久 ？ 
how far away is the airport ? 	到 机场 有多远 ？ 
i do n't think my life is very interesting . 	我 不 认为 我 的 人生 很 有趣 。 
i noticed a pa@@ tter@@ n . 	我 注意 到 一个 图案 。 
no , i did n't go . 	不 ， 我 没 去 。 
could you solve the problem ? 	你 能 解决 这个 问题 吗 ？ 
u@@ k is the ab@@ b@@ re@@ vi@@ ation for the united kin@@ g@@ dom . 	UK 是 英国 的 缩写 。 
my grandfather died when i was a boy . 	当 我 是 个 小 男孩 的 时候 ， 我 的 祖父 就 过世 了 。 
wine is made from grapes . 	葡萄酒 是 用 葡萄 做成 的 。 
it makes no sense wha@@ t@@ so@@ ever . 	无论如何 说 不通 。 
tom enjo@@ ys gar@@ d@@ ening . 	汤姆 享受 园艺 。 
i do n't like eating meat . 	我 不 喜欢 吃 肉 了 。 
i 'll think it over carefully . 	我会 深思熟虑 。 
i like l@@ .@@ a@@ . better . 	我 更 喜欢 洛杉矶 。 
my brother is a college student . 	我 哥哥 是 个 大学生 。 
he is fluent in chinese . 	他 能 说 流利 的 中文 。 
i would n't try that again . 	我 不会 再试 了 。 
there was a shor@@ tage of fuel . 	燃料 短缺 。 
she scolded her son for being lazy . 	她 骂 她 的 儿子 懒惰 。 
i 'm always busy with my homework . 	我 总是 忙于 功课 。 
at first , he could not speak english at all . 	起初 ， 他 不会 说 英语 。 
he had a hungry look . 	他面 有 饥色 
the taxi 's here . 	出租车 到 了 。 
i was n't im@@ pl@@ ying anything . 	我 没有 暗示 甚么 。 
i 'm getting off at the next station . 	我下 一站 下车 。 
i will be free tomorrow afternoon . 	我 明天 下午 有空 。 
you may inj@@ ure yourself if you do n't follow safety proce@@ dur@@ es . 	如果 你 不 按照 安全 手续 来 的话 ， 你 可能 会 受伤 的 。 
she goes to a@@ er@@ o@@ bi@@ cs once a week . 	她 每 星期 去作 一次 健美操 。 
how much did you bi@@ d ? 	你 出价 多少 ？ 
i 'm not sure tom would help . 	我 不 确定 汤姆 能 不能 帮忙 。 
the ball is that boy 's pri@@ zed pos@@ se@@ ssion . 	这个 球是 那个 男孩 的 宝贝 。 
i 'm almost sure of it . 	我 几乎 能 确定 。 
he painted all the wa@@ lls green . 	他 把 所有 的 墙壁 漆成 了 绿色 。 
the company went bankrupt . 	公司 破产 了 。 
people must love one another . 	人要 爱 他人 。 
for here , or to go ? 	内用 还是 外带 ? 
i finally found a job . 	我 终于 找到 工作 了 。 
i do n't know . 	我 一无所知 。 
he was hit by a car and died in@@ stantly . 	他 被 车 撞 了 之后 便 过世 了 。 
the big tree was struck by lightning . 	这棵 大树 遭到 雷击 。 
he is not as intelligent as his older brother . 	他 不 像 他 的 兄长 那样 聪明 。 
she usually goes to bed at nine . 	她 经常 九点 睡觉 。 
by the way , what 's your address ? 	对 了 ， 你 的 地址 是 什么 ? 
tom has many cats . 	汤姆 有 很多 猫 。 
would you like a cup of coffee ? 	你 要 来 杯 咖啡 吗 ? 
did you drive her home last night ? 	昨晚 你 把 她 送 回家 了 吗 ？ 
we sell orange juice . 	我们 卖柳 橙汁 。 
tom speaks without thinking . 	汤姆 不假思索 脱口而出 。 
i could n't answer all the questions . 	我 无法 回答 所有 问题 。 
he 's lazy . 	他 很 懒 。 
the boy is eating bread . 	这个 男孩子 在 吃 面包 。 
each year ha@@ ma@@ ma@@ t@@ s@@ u has a kite festival . 	每年 滨松 有 风筝节 。 
president lincoln accepted the invitation . 	林肯 总统 接受 了 邀请 。 
he is looking forward to it . 	他 对此 很 期待 。 
this is n't good . 	这 不好 。 
about how much will i have to pay for all the treat@@ ments ? 	所有 的 医药费 我 大概 要付 多少 ？ 
you 're so beautiful ! 	你 太 漂亮 了 ！ 
we did n't have much rain last month . 	上个月 我们 这儿 没有 下 很多 雨 。 
she went there yesterday . 	她 昨天 去 那里 。 
i 'm going to change my shirt . 	我要 去 换 我 的 衬衫 。 
what time will you leave ? 	你 什么 时候 离开 ？ 
i have no intention of asking him . 	我 不想 问 他 。 
it 's a ha@@ ss@@ le trying to decide what to wear to the party . 	要 决定 在 节日 的 时候 穿 什么 是 件 累人 的 事 。 
these are pens . 	这些 是 笔 。 
he is washing his car . 	他 正在 洗 他 的 车 。 
children like chocolate . 	孩子 们 喜欢 巧克力 。 
i met him on my way home . 	我 在 回家 的 路上 遇见 了 他 。 
she ignored all my warnings . 	她 忽视 了 我 所有 的 警告 。 
the shooting started around noon . 	枪击 是 在 中午 十二时 左右 开始 的 。 
she promised not to go out alone . 	她 答应 不 单独 外出 。 
maybe you 'll succeed . 	也许 你 会 成功 。 
she helped me pac@@ k my suitcase . 	她 帮 我 打包 我 的 手提箱 。 
her eyes sh@@ one with jo@@ y when she saw that her mother was not mad at her . 	当 她 看到 妈妈 没在生 她 的 气 ， 她 的 双眼 因为 幸福 而 闪烁 了 。 
i could n't prevent tom from eating all the cookies . 	我 阻止 不了 汤姆 把 饼干 全吃 了 。 
he was completely eng@@ ro@@ ssed in the book . 	他 完全 沉浸 在 书里 。 
she gets up late on sunday mor@@ nings . 	她 每周 日 早上 很晚 起床 。 
he gave me whatever help i needed . 	他 给 了 我 任何 我 需要 的 帮助 。 
all i want to do is go fishing . 	我 唯一 想 做 的 是 去 钓鱼 。 
my uncle has a flower shop near the station . 	我 叔叔 在 车站 附近 有 一家 花店 。 
it is warmer today than yesterday . 	今天 比 昨天 暖和 。 
i respect the el@@ der@@ ly . 	我 尊敬 长辈 。 
i wonder if you have something to write with . 	我 怀疑 你 是否 有 东西 可写 。 
i wanted to sma@@ ck you . 	我 想 过 扇 你 一 巴掌 。 
i want you to stay here until i get back . 	我 想 你 待 在 这里 直到 我 回来 。 
the police@@ men arrested the burglar . 	警察 逮捕 了 窃贼 。 
he had n't eaten in two days . 	他 已经 两天 没 吃 东西 了 。 
i 'm not particularly thirsty right now . 	我 现在 不 特别 渴 。 
really ? 	你 确定 ？ 
she spent all afternoon cooking . 	她 花 了 整个 下午 作饭 。 
you may depend on him to help you . 	你 或许 可以 依靠 他来 帮助 你 。 
tom will be a teacher someday . 	汤姆 有 一天 会 成为 教师 。 
i need to know . 	我 需要 知道 。 
nothing is worse than war . 	没有 什么 比 战争 更 糟 的 了 。 
how much does this hat cost ? 	这顶 帽子 多少 钱 ？ 
everyone hoped that she would win . 	每个 人 都 希望 她 会 获胜 。 
we 're just about finished here . 	我们 快要 结束 了 。 
i was happy to see him . 	我 很 高兴 见到 他 。 
he told me his life 's story . 	他 跟 我 讲 了 他 的 人生 故事 。 
the moonlight is beautiful . 	月光 真美 。 
i do n't know if that 's what tom wants or not . 	我 不 知道 那 是不是 汤姆 想要 的 。 
he is a scre@@ w@@ ball . 	他 是 一个 怪人 。 
i know where he lives . 	我 知道 他 住 哪儿 。 
the house i 'm living in is n't very large . 	我 住 的 房子 不是 太大 。 
people used to laugh at us . 	人们 以前 笑话 我们 。 
he lives in that house over there . 	他 住 在 那边 的 那间 房子 。 
he always takes sides with her . 	他 总是 支持 她 。 
the accident happened on sunday at about 3@@ :00 . 	此 事故 发生 在 周日 3 点 左右 。 
it is me that is wrong . 	是 我 错 了 。 
au@@ ck@@ land is a city in new zealand . 	奥克兰 是 一座 新西兰 的 城市 。 
give me the same , please . 	请 给 我 同样 的 东西 。 
where 's the nearest shopping ma@@ ll ? 	最近 的 大 卖场 在 哪里 ？ 
always do right . this will gra@@ ti@@ fy some people and astoni@@ sh the rest . 	坚持 做 对 的 事情 。 这会 满足 一部分 人 同时 使 另 一部分 人 感到 惊讶 。 
we surrender . 	我们 投降 。 
let me make you some tea . 	让 我 给 你 沏茶 。 
he hit the ball with his racket . 	他用 他 的 球拍 击球 。 
your time is up . 	你 的 时间 到 了 。 
tom needed to wash his car . 	汤姆 需要 洗 他 的 车 。 
tom needs to up@@ date his website . 	汤姆 需要 更新 他 的 网站 。 
i usually walk to school . 	我 通常 走 去 学校 。 
i 've gained weight . 	我 增加 了 体重 。 
you are a good person . 	您 是 一个 好人 。 
you speak good english . 	你 的 英语 说 得 很 好 。 
i like your shoes . 	我 喜欢 你 的 鞋子 。 
i looked around , but saw nobody . 	我 环顾 四周 ， 却 没 看见 任何人 。 
come and see me tomorrow . 	明天 来看 看 我 。 
he could n't hold his temper any longer . 	他 再也 忍不住 气 了 。 
he gave me a smile of recogni@@ tion . 	他 给 了 我 一个 认可 的 微笑 。 
mary went down to the kitchen . 	玛丽 下楼 到 厨房 。 
i 'm sorry . 	对不起 。 
my mother is a very good cook . 	我 妈妈 是 一个 很 棒 的 厨师 。 
at last , it began to rain . 	终于 开始 下雨 了 。 
i do n't like to leave things up in the air . 	我 不 喜欢 让 事情 悬而未决 。 
i like red wine better than white . 	我 喜欢 红葡萄酒 胜过 白葡萄酒 。 
tom seems to have a cold . 	汤姆 看来 感冒 了 。 
i take my health seriously . 	我 重视 自身 的 健康 。 
here is the bill . 	这是 账单 。 
he made me go against my will . 	他 让 我 违背 了 我 的 意愿 。 
come again next week . 	下周 再来 。 
are you and tom working together ? 	你 跟 汤姆 一起 工作 吗 ？ 
the doctor called him back . 	医生 把 他 叫 了 回来 。 
the population of the city is about 10@@ 0,000 . 	这座 城市 的 人口 约 有 100 000 。 
i quit . 	我 退出 。 
he is still here . 	他 还 在 这儿 。 
it was a terrible day . 	这是 糟糕 的 一天 。 
tom never saw her again . 	汤姆 没 再见 过 她 。 
a dog was run over by a truck . 	一条 狗 被 卡车 碾过 。 
whose turn is it ? 	轮到 谁 了 ？ 
clean the dirt off the mirror . 	清理 镜子 上 的 灰尘 。 
i 'm looking forward to seeing him . 	我 期待 再次 见到 他 。 
we 've received a lot of appli@@ ca@@ tions in answer to our adverti@@ se@@ ments . 	我们 已经 收到 了 很多 回应 我们 广告 的 申请 。 
how will the weather be tomorrow ? 	明天 天气 怎么样 ？ 
tom is crying outside right now . 	汤姆 现在 正在 外面 哭 。 
my father has been to australia twice . 	我 父亲 曾经 去过 澳洲 两次 。 
she made coffee for all of us . 	她 为 我们 所有 的 人 煮 咖啡 。 
do n't you ever clean your room ? 	你 从不 清扫 你 的 房间 吗 ？ 
i 'm a foreigner and i do n't know c@@ z@@ e@@ ch very well . please , speak slowly . 	我 是 外国人 ， 我 捷克语 不好 ， 请 说 慢 一点 。 
tom wants to be the boss . 	汤姆 想当 老板 。 
arabi@@ c is read from right to left . 	阿拉伯语 要 从 右往 左读 。 
tom did n't like the idea . 	汤姆 不 喜欢 这个 主意 。 
tom worked hard to get the work done on time . 	汤姆 努力 工作 按时 完成 工作 。 
write your name in capital letters . 	写下 你 名字 的 大写字母 。 
is she all right ? 	她 是 正确 的 吗 ？ 
this book belongs to the library . 	这 本书 是 图书馆 的 。 
no problem . 	没 问题 。 
tom helped mary buy everything she needed . 	汤姆 帮 玛丽 买 了 她 所有 需要 买 的 东西 。 
what you said is not true . 	你 说 的 不是 真的 。 
asia is much larger than australia . 	亚洲 比 澳洲 大 很多 。 
a little bit of luck sometimes lea@@ ds to an unexpected success . 	一点点 的 运气 有时 会 导致 意想不到 的 成功 。 
another bottle of wine , please . 	麻烦 再 一瓶 葡萄酒 。 
i was very surprised to hear the news . 	我 听到 这个 消息 很 惊讶 。 
do you know how to play mahjong ? 	你 知道 怎么 打 麻将 吗 ？ 
you are not a coward . 	你 不是 个 懦夫 。 
tom listened carefully . 	汤姆 仔细 听 。 
tom is lucky he did n't get shot . 	汤姆 没 被 射中 真 走运 。 
tom had a hun@@ ch that mary was seeing someone else . 	汤姆 预感 到 玛丽 在 见 别人 。 
tom waved his hand . 	汤姆 挥手 了 。 
who 's the boss of this company ? 	这家 公司 的 老板 是 谁 ？ 
is it hard to speak english ? 	说 英语 很难 吗 ? 
when i was young , i used to climb trees a lot . 	我 年轻 时 经常 爬树 。 
she thanked us for our help . 	她 感谢 我们 的 帮助 。 
i do n't know why you 're here . 	我 不 知道 你 为 甚么 在 这里 。 
please drive the car more slowly . 	请 开车 开慢 一点 。 
tom always makes me laugh . 	汤姆 总是 让 我 笑 。 
two men are che@@ cking on what 's wrong with the car . 	两个 男人 在 检查 汽车 出 了 什么 故障 。 
the baby can not use a spoon yet . 	宝宝 还 不会 使用 勺子 。 
the dog grow@@ led at a little boy . 	这 只 狗 对 著 一个 小 男孩 咆哮 。 
these flowers are beautiful , are n't they ? 	这些 花 很 美 ， 不是 吗 ？ 
what 're you looking at ? 	你 在 看 什么 ？ 
we will have learned english for five years next year . 	到 明年 我们 学 英语 就 有 5 年 了 。 
i wash my hands before eating lunch . 	我 在 吃 午饭 前 洗手 。 
my ce@@ ll phone has a bui@@ l@@ t-@@ in di@@ gi@@ tal camera . 	我 的 手机 有 内建 的 数位 相机 。 
she cut the apple with a knife . 	她 用 刀子 切 苹果 。 
do n't talk to others during the class . 	上课 中 不要 跟 别人 讲话 。 
the island is a par@@ adi@@ se for children . 	这个 岛 是 孩子 们 的 天堂 。 
if we do n't keep walking we 'll be late . 	如果 我们 不 继续 赶路 ， 我们 会 迟到 的 。 
the tsunam@@ i alert was cancel@@ led . 	海啸 的 警报 解除 了 。 
tom will return home tomorrow . 	汤姆 明天 回家 。 
he is in london on business now . 	他 现在 在 伦敦 洽公 。 
do you have a pen on you ? 	你 身上 有 铅笔 吗 ？ 
you were supposed to tell tom that . 	你 该 告诉 汤姆 。 
could you put my name on the waiting list ? 	你 能 把 我 的 名字 加到 等候 批准 的 申请人 名单 上 吗 ？ 
i promised him that i would come today . 	我 答应 他 我 今天 会来 。 
how many kids do you have ? 	你 有 几个 孩子 ? 
do you know which de@@ ity this temple is dedicated to ? 	您 知道 这座 庙宇 供奉 的 是 哪个 神 吗 ？ 
what can tom do ? 	汤姆 能 做 什么 ？ 
i was late to school . 	我 上学 迟到 了 。 
there is a photo of tom on mary 's desk . 	在 玛丽 的 桌上 有张 汤姆 的 照片 。 
have you seen all these movies ? 	你 把 电影 全看 了 吗 ？ 
tom is n't as innocent as he seems . 	汤姆 不像 他 看上去 的 那样 无辜 。 
i wish i had more money . 	我 希望 我 有 更 多 钱 。 
i graduated from kyoto university . 	我 毕业 于 京都大学 。 
my father is very angry with me . 	我 父亲 对 我 非常 生气 。 
yours is over there . 	你 的 在 那儿 呢 。 
it 's hot out here . 	这里 够 热 。 
weather 's pretty nice tonight . 	今晚 的 天气 不错 。 
the cottage was clean and ti@@ dy . 	小屋 干净 又 整洁 。 
how did you know that was my favorite one ? 	你 怎么 知道 那 是 我 最 喜欢 的 ？ 
his horse jumped over the fence . 	他 的 马 跳 过 了 栅栏 。 
my uncle made a will last year . 	我 叔叔 去年 立下 了 遗嘱 。 
i told them to send me another ticket . 	我 请 他们 再 寄 给 我 一张 票 。 
i like walking at night . 	我 喜欢 在 夜晚 走路 。 
i was n't yel@@ ling . 	我 没有 在 吼 。 
we had a heavy fro@@ st this morning . 	今天 早上 下厚霜 了 。 
we were able to catch the last train . 	我们 能 赶上 最后 一班 火车 。 
why did n't you read the magazine ? 	你 为什么 不读 这 杂志 呢 ？ 
she left early in the morning . 	她 清晨 离开 了 。 
you 're really a hard worker . 	你 真是 个 努力 的 工人 。 
they do n't even know why . 	他们 甚至 不 知道 为什么 。 
she managed to keep up app@@ ear@@ an@@ ces . 	她 设法 保住 面子 。 
i like the way she laughs at my jokes . 	我 喜欢 她 因 我 的 笑话 而 欢笑 的 样子 。 
do you have a list of hote@@ ls ? 	你 有 旅馆 名录 吗 ？ 
i have two sons . 	我 有 两个 儿子 。 
he quickly made friends with the new boy on the b@@ lock . 	他 很快 便 与 小 区里 新来 的 男孩 交上 了 朋友 。 
give the book to w@@ home@@ ver wants it . 	这 本书 谁 想要 就 给 谁 吧 。 
she was busy with house@@ hold work . 	她 忙于 家务 。 
she 's really smart , is n't she ? 	她 真的 很 聪明 ， 不是 吗 ？ 
we ca n't escape . 	我们 逃 不 出去 。 
was this wall built to keep people out or to keep them in ? 	建造 这 堵墙 是 为了 把 人 隔 在 外面 还是 把 他们 留在 里面 ？ 
she lives in a t@@ wo@@ -@@ story house . 	她 住 在 一栋 两层 楼 的 房子 。 
is it safe to skate on this lake ? 	在 这个 湖上 滑冰 安全 吗 ？ 
she gave him a sweater . 	她 给 他 一件 毛衣 。 
we had to go there together . 	我们 必须 一起 去 。 
you can bank on that . 	你 可以 相信 那个 。 
i still have a question . 	我 还有 个 问题 。 
do you like to drink wine ? 	你 喜欢 喝 红酒 吗 ？ 
this do@@ gh@@ ouse was built by tom . 	这狗屋 是 汤姆 建 的 。 
she has a strong wish to work as an interpreter . 	她 非常 想当 口译 。 
i met a smi@@ th at the party . 	我 在 聚会 上见 了 史密斯 。 
no one listened to me . 	没有 人 听 我 的 。 
his letter makes me un@@ easy . 	他 的 来信 让 我 不安 。 
tom saw mary crying . 	汤姆 看见 玛丽 在 哭 。 
in case of emergency , call 1@@ 1@@ 9 . 	在 紧急 情况 下 ， 可 拨打 119 。 
i wonder what i should do today . 	我 在 想 我 今天 该 干什么 。 
i remember this map . 	我 记得 这张 地图 。 
we 're waiting for tom . 	我们 在 等 汤姆 。 
tom is there alone . 	Tom 独自 在 那 。 
these two words are easily confused . 	这 两个 词 容易 混淆 。 
have you ever seen such a nice film ? 	你 看过 这么 好看 的 电影 吗 ？ 
how do you pronounce this word ? 	你们 怎么 读 这个 词 ？ 
he knows how to play the piano . 	他 知道 如何 弹 钢琴 。 
i do n't want to swim . 	我 不想 游泳 。 
no one ran ahead of him . 	没有 人 跑 在 他 前面 。 
she wants to attend the party . 	她 想 参加 这个 派对 。 
i 've seen a lot of him recently . 	我 最近 常 看到 他 。 
that dog is big . 	这 只 狗 很大 。 
i did n't study at all yesterday . 	我 昨天 都 没 读书 。 
what tom said was n't true . 	汤姆 说 的 不是 真的 。 
i will not allow you to use my pen . 	我 不 允许 你 用 我 的 钢笔 。 
tom is over@@ weight . 	汤姆 超重 了 。 
i think you 've done this before . 	我 想 你 以前 做过 这个 。 
he 's much younger than tom . 	他 比 Tom 年轻 得 多 。 
her husband is an excellent cook . 	她 丈夫 是 个 优秀 的 厨师 。 
they 're afraid of us . 	他们 害怕 我们 。 
she does nothing but complain . 	她 什么 都 不 做 只会 抱怨 。 
we took a walk in the park . 	我们 在 公园 里 散步 。 
you only gave me fifty c@@ ents . 	你 只 给 了 我 五十 美分 。 
his advice coun@@ ted for little . 	他 的 建议 不算 什么 。 
she kept crying all night . 	她 一整 晚 都 在 哭 。 
that 's a nice tie you 're wearing . 	你 打 了 一条 不错 的 领带 。 
i could see that . 	我能 看见 。 
so what if that 's true ? 	那 如果 那 是 真的 呢 ？ 
this is at@@ ro@@ cious weather . 	恶劣 的 天气 。 
yesterday i spent the whole day working . 	昨天 我 一整天 都 在 工作 。 
are you listening to english ? 	你 在 听 英语 吗 ？ 
how soon can we leave ? 	我们 过 多久 才能 离开 ？ 
if it is fine tomorrow , we 'll go on a picnic . 	如果 明天 天气 好 ， 我们 就 去 野餐 。 
what vegetables do you like to eat ? 	你 喜欢 吃 什么 菜 ？ 
a few minutes later , the telephone rang . 	几分钟 后 ， 电话响 了 。 
i invited him to the party and he accepted . 	我 邀请 他 去 派对 ， 他 接受 了 。 
make yourself at home . 	就 当 在家 一样 。 
tom 's mother is a nurse at the hospital that 's across the street from where mary lives . 	汤姆 的 妈妈 是 一名 护士 ， 她 所在 的 医院 就 在 玛丽 住 的 那条 街 的 对面 。 
it 's a basic human right . 	它 是 基本 人权 。 
i swear i 'll never do such a thing . 	我 发誓 我 不会 做 这种 事 。 
december has thir@@ ty-one days . 	十二月 有 三十 一天 。 
it has been raining heavily for three hours . 	下 了 三 小时 大雨 。 
where do you live now ? 	你 现在 住 在 哪里 ？ 
tom wants me to stay away from him . 	Tom 要 我 离 他 远 一点 。 
i 'm a good cook . 	我 是 个 好 厨师 。 
the goods were tran@@ spor@@ ted by ship . 	这批 货物 是 由 船只 运送 的 。 
there 's nobody in the building now . 	现在 建筑 里 没人 。 
we enjoyed swimming in the river . 	我们 喜欢 在 河里 游泳 。 
i have n't seen you in ages . 	我 已经 好久 没有 见到 你 了 。 
tom fell asleep sitting up in the chair . 	汤姆 坐在 椅子 上 睡着 了 。 
he could not for@@ sa@@ ke his friend in trouble . 	他 不会 抛 下落 难 的 朋友 不管 。 
i saw him run away . 	我 看见 他 逃跑 了 。 
please eat some cake . 	请吃 点 蛋糕 。 
let 's meet at one o'clock . 	让 我们 一点 钟 见面 吧 。 
please remember to mail the letter . 	请 记得 把 信 寄 出去 。 
hang on till i get to you . 	坚持 下去 直到 我 找到 你 。 
a growing child who does n't seem to have much energy perhaps needs medical attention . 	一个 成长 中 的 孩子 如果 没有 充足 的 能量 ， 可能 需要 药物 治疗 。 
we could do something big . 	我们 能 做点 大事 。 
when i hear this song , i think of you , and miss you . 	当 我 听到 这 首歌 ， 我 想起 了 你 ， 并 想念 著 你 。 
the dog cha@@ sed the rabbit . 	狗 追 兔子 。 
he 's not very strict about this . 	他 在 这方面 不是 很 严格 。 
can you think of something better ? 	你 能 想到 更好 的 东西 吗 ？ 
i was afraid i 'd be late . 	我怕 我会 迟到 。 
i should obey . 	我 应该 服从 。 
mary is studying in her room . 	玛丽 在 她 的 房间 里 读书 。 
spring is the best season to visit kyoto . 	春天 是 访问 京都 最好 的 季节 。 
she had an appointment with the doctor . 	她 跟 医生 预约 看诊 了 。 
`` how old are you ? '' `` i 'm 1@@ 6 years old . '' 	「 你 几岁 ？ 」 「 我 十六岁 。 」 
tom and i have known each other for a long time . 	汤姆 和 我 相识 很久 了 。 
tom wondered what he could do . 	汤姆 不 知道 他 能 做 什么 。 
i can swim very fast . 	我 游泳 可以 游得 很快 。 
the moon is shining . 	月光 在 照耀 著 。 
you 're drinking out of my cup . 	你 正在 把 我 杯子 里 的 东西 喝掉 。 
what time is it by your watch ? 	你表上 是 几点 ？ 
she took full advantage of her stay in london to improve her english . 	她 充分 利用 她 住 在 伦敦 的 优势 ， 提高 英语 。 
you must hurry up . 	您 要 赶快 些 。 
i 'm tired of listening to tom . 	我 厌倦 了 听 汤姆 说话 。 
you 're cu@@ ter than mary . 	你 比 玛丽 可爱 。 
the man got away from the city . 	这名 男子 逃离 了 这个 城市 。 
did you watch the soccer game on television ? 	你 在 电视 上 看 足球赛 了 吗 ？ 
that is n't fair . 	这 不 公平 。 
you had better be careful not to over@@ eat . 	你 最好 小心 不要 吃 过量 。 
what was the cause of the explosion ? 	爆炸 的 原因 是 什么 ？ 
i thought tom would be worried . 	我 以为 汤姆 会 感到 担心 。 
i usually walk to school . 	一般 我 步行 去 学校 。 
i still ca n't believe i did it . 	我 仍旧 无法 相信 我 居然 做 了 这种 事 。 
she asked him to mail that letter . 	她 请 他 寄 那 封信 。 
after supper , she cleared the table . 	晚 饭后 她 清理 了 桌子 。 
please knock before you come in . 	进来 之前 请 敲门 。 
i listened to some records last night . 	我 昨晚 听 了 一些 唱片 。 
i have n't seen you around here before . 	我 以前 在 这里 没见 过 你 。 
which is your favorite team ? 	你 最 喜欢 哪 一队 ? 
do you have a temperature ? 	你 发烧 了 吗 ？ 
you 're much less likely to get a good position if you do n't speak english . 	如果 你 不会 说 英语 ， 你 就 很 难 得到 一个 好 的 职位 。 
write it down before you forget it . 	在 你 忘记 之前 把 它 写 下来 。 
no way ! 	没门 ！ 
you may as well come with me . 	你 不如 跟 我 一 起来 。 
i ca n't finish the job in so short a time . 	我 无法 在 这么 短 的 时间 内 完成 这份 工作 。 
i 'm glad i was there . 	我 很 高兴 我 在 那里 。 
we made the most of the opportunity . 	我们 尽力 地 利用 了 这个 机会 。 
when does tom eat breakfast ? 	汤姆 什么 时候 吃 早饭 ？ 
how could it be tom 's fault ? 	它 怎么 能 是 汤姆 的 错 ？ 
i guess you 're right . 	我 猜 你 是 对 的 。 
if he were a little younger , he would be e@@ ligi@@ ble for the post . 	如果 他 年轻 一点 ， 他 将 很 适合 这个 职位 。 
flying a kite can be dangerous . 	放 风筝 可以 是 危险 的 。 
she married a rich old man . 	她 嫁 给 了 个 有钱 老头 。 
i 've finally got the whole set ! 	我 终于 拥有 了 一整套 ! 
if we were supposed to talk more than listen , we would have been given two mou@@ ths and one ear . 	如果 我们 应该 少 听 多 说话 , 那么 我们 应该 得到 两个 嘴巴 一只 耳朵 才 是 。 
there are many hote@@ ls downtown . 	市中心 有 很多 旅馆 。 
you may take anything you like . 	你 可以 拿 你 喜欢 的 东西 。 
she is not as young as she looks . 	她 没 她 看上去 那么 年轻 。 
i 've never seen tom laugh . 	我 从没 见 汤姆 笑 。 
they are all college students . 	他们 都 是 大学生 。 
please take off your shoes . 	请 脱掉 你 的 鞋子 。 
this book is very thi@@ ck . 	这 本书 非常 厚 。 
what have i ever done to tom ? 	我 对 汤姆 做 了 什么 ？ 
where do you work now ? 	你 现在 在 哪里 工作 ？ 
she got over the sho@@ ck of her father 's death . 	她 从 她 父亲 过世 的 震惊 中 恢复 了 。 
it 's a beautiful painting . 	是 一幅 漂亮 的 画 。 
i 'll leave that to you . 	我会 留给 你 。 
i 'll join you all later . 	我 晚会 加入 你们 。 
he is rarely in a good mood . 	他 很少 心情 很 好 。 
she has hund@@ re@@ ds of books . 	她 有 几百 本书 。 
do you play any instru@@ ments other than the piano ? 	除了 钢琴 以外 ， 还会 玩 什么 乐器 吗 ？ 
tom does n't eat meat and neither does mary . 	汤姆 不吃 肉 ， 玛丽 也 是 。 
god exists . 	上帝 存在 。 
i prefer cats to dogs . 	较之 于 狗 ， 我 更 喜欢 猫 。 
tom never should 've tried doing that by himself . 	汤姆 从来不 应该 尝试 自己 一个 人 做 那些 。 
the sun gives us light and heat . 	太阳 提供 我们 光和热 。 
there are more clouds today than yesterday . 	今天 的 云 比 昨天 的 多 。 
i am off today . 	我 今天 休息 。 
could you call me tonight , please ? 	今晚 你 能 打电话 给 我 吗 ？ 
speaking english is useful . 	说 英语 很 有用 。 
the teacher told us a funny story . 	老师 跟 我们 说 了 一个 有趣 的 故事 。 
i 'm ok . 	我 没事 。 
it is not easy to distinguish good from evi@@ l . 	区分 善恶 不 容易 。 
i know that tom is hungry . 	我 知道 汤姆 饿 了 。 
he took it liter@@ ally . 	他 按照 字面 上 的 意思 。 
your plan seems better than mine . 	你 的 计划 似乎 比 我 的 好 。 
i want to see your mother . 	我 想 看看 你 的 母亲 。 
it 's impossible to get there by noon . 	中午 到达 那里 是 不 可能 的 。 
do you study at a private school ? 	你 在 私立 学校 读书 吗 ？ 
he often laughs at his own jokes . 	他 常常 因 他 自己 的 笑话 而 笑 。 
he was waiting for a long time . 	他 等 了 很长 的 时间 。 
there was n't a soul in sight . 	一个 人影 也 看不到 。 
i an@@ tici@@ pa@@ te that there will be trouble . 	我 预料 会 有 麻烦 。 
was that what tom said ? 	那 就是 汤姆 说 的 吗 ？ 
this is tom 's car . 	这是 胡安 的 车 。 
he 's younger than me . 	他 比 我 年轻 。 
part of his story is true . 	他 的 故事 一部分 是 真的 。 
tom told mary that she was right . 	汤姆 告诉 玛丽 她 是 对 的 。 
have you given tom everything ? 	你 全都 给 汤姆 了 吗 ？ 
i 'd like to see your father . 	我 想 去 看 你 的 父亲 。 
do you deli@@ ver on sundays ? 	你们 周日 送货 吗 ？ 
it 's true . 	这是 真的 。 
breakfast is from seven to nine . 	早餐 时间 在 七点 到 九点 。 
we were on the same train by chance . 	我们 偶然 间 乘 了 同一 列 列车 。 
i 'd like an orange juice . 	我 想要 一杯 柳 橙汁 。 
tom took this photo . 	汤姆 拍 了 这 张照 。 
i do n't know where he comes from . 	我 不 知道 他 从 哪里 来 。 
bring the water to a boil . 	把 水 烧开 。 
where 're the shoes ? 	鞋子 在 哪儿 ？ 
did i tell you i got a new job ? 	我 有 告诉 你 我 找到 新 工作 了 吗 ？ 
i could barely get out of bed yesterday . 	我 昨天 几乎 下 不了 床 。 
let 's start right away . 	我们 立刻 开始 吧 。 
which tooth hurts ? 	哪颗 牙痛 ？ 
i ca n't bring myself to do such a thing . 	我 不能 让 自己 做 这样 的 事 。 
people who break the law are punished . 	触犯 法律 的 人 受到 惩罚 。 
he shot an ar@@ row at the de@@ er . 	他射 了 鹿一箭 。 
my throat feels dry . 	我 喉咙 很 干 。 
he 's doing his best . 	他 在 全力以赴 。 
please return the book by tomorrow . 	请 明天 前 还 书 。 
do you have a table on the pati@@ o ? 	你 院子 里 有 桌子 吗 ? 
allow me to go . 	请 允许 我 去 。 
it can be dangerous . 	它 有 危险 。 
my father told me where to go . 	我 爸爸 告诉 我 去 哪儿 。 
not a single person arrived late . 	没有 一个 人 迟到 。 
i 'm a new student . 	我 是 个 新生 。 
take care . 	照顾 好 自己 。 
you look as healthy as ever . 	你 看起来 和 以前 一样 健康 。 
those two children were the same age . 	那 两个 小孩 同岁 。 
are they both the same ? 	他们 都 是 一样 的 吗 ？ 
wo n't you have some tea with me ? 	你 不 和 我 一起 喝点 茶 吗 ？ 
we 'll know the truth before long . 	我们 不久 将 知道 真相 。 
mother made a doll for me . 	妈妈 给 我 做 了 一个 洋娃娃 。 
i got up early as usual . 	我 和 往常 一样 起得 很早 。 
tom usually does n't make mistakes . 	汤姆 通常 不 犯错 。 
tom said he 's glad mary has finally graduated . 	汤姆 说 他 很 高兴 玛丽 毕业 了 。 
he made fun of me in public . 	他 在 公共 场合 取笑 了 我 。 
where are we meeting ? 	我们 在 哪里 见面 ？ 
i do n't know where he lives . 	我 不 知道 他 住 在 哪里 。 
you 'd better consult your doctor . 	你 最好 请教 你 的 医生 。 
the old man gave the child shelter . 	这位 老人 收容 了 这个 孩子 。 
it 's supper time . 	吃 晚饭 的 时间 到 了 。 
after climbing mt . fuji , i got the in@@ spi@@ ra@@ tion for a poem . 	攀登 富士山 后 ， 我 得到 了 一首 诗 的 灵感 。 
your manners are n't very good . 	你 的 礼貌 不是 很 好 。 
i have lost my cap . 	我 把 帽子 弄 丢 了 。 
english is used by many people . 	英语 是 被 许多 人 使用 。 
why are there so many people ? 	怎么 这么 多人 。 
when will the world come to an end ? 	世界 末日 是 什么 时候 ？ 
i 'm glad to make your acqua@@ int@@ ance . 	我 很 高兴 能够 认识 您 。 
life is not all fun and games . 	生活 并 不 都 是 轻松 愉快 的 。 
do you plan to stay long ? 	你 打算 长时间 停留 吗 ？ 
your parents loved you very much . 	你 的 父母 很 爱 你 。 
i do n't know right now . 	我 现在 不 知道 。 
life goes on . 	人生 会 继续 。 
we got him to carry our bag . 	我们 让 他 帮 我们 拿 袋子 。 
tom is here because of me . 	因为 我 ， 汤姆 在 这里 。 
what did you have to eat ? 	你 必须 吃 什么 ? 
english has become an international language . 	英语 成为 了 一门 国际 语言 。 
the king cru@@ shed his enemies . 	国王 摧毁 了 他 的 敌人 。 
he is fluent in french . 	他 说 法语 说 得 很 流利 。 
put it on one bill , please . 	请记 在 一张 帐 单上 。 
you should n't say that kind of thing when children are around . 	孩子 们 在 旁边 的 时候 ， 你 不 应该 说 那种 事 。 
i have no energy today . 	今天 我 没有 精神 。 
do n't p@@ ry into my private life . 	不要 插手 我 的 私生活 。 
i am here on business . 	我 在 这里 出差 。 
please give me a glass of milk . 	请 给 我 一杯 牛奶 。 
i was so home@@ sick . 	我 很 想家 。 
we take it for granted that he will succeed in his business . 	我们 认为 他 的 生意 理所当然 会 获得 成功 。 
he arrived at the station at seven . 	他 7 点到 了 火车站 。 
she is upset . 	她 心情 不好 。 
she has seen better days . 	她 看到 了 更好 的 明天 。 
i could n't have done it without you . thank you . 	没有 你 我 无法 做到 ， 谢谢 。 
compared to our house , yours is a man@@ sion . 	跟 我们 的 房子 比 ， 你 的 就是 个 豪宅 。 
they decided to build a bridge . 	他们 决定 建 一座 桥 。 
tom was n't in bed . 	汤姆 不 在 床上 。 
he likes to travel alone . 	他 喜欢 独自 旅行 。 
he is ap@@ t to be late . 	他 很 容易 迟到 。 
the monkey climbed up a tree . 	猴子 爬 上 了 树 。 
a boy is walking across the street . 	一个 男孩 正 沿着 街 走 。 
a par@@ ro@@ t can mi@@ mic a person 's voice . 	鹦鹉 会 模仿 人 的 声音 。 
tom , you 'd better stay here . 	汤姆 ， 你 留在 这里 比较 好 。 
i walked as far as the station . 	我们 走到 跟 火车站 那样 远 的 地方 。 
she was in a hurry to see her father . 	她 急于 见 她 的 父亲 。 
the boy who lives next door often comes home late . 	住 在 隔壁 的 男孩 常常 很晚 回来 。 
here we are ! 	我们 到 了 ！ 
it 's late . 	很晚 了 。 
put your weap@@ on down . 	把 你 的 武器 放下 。 
she got first prize in the eating con@@ test . 	她 在 吃 东西 比赛 里 得 了 一等奖 。 
i held my breath and waited . 	我 屏住 了 呼吸 等待 着 。 
it 's going to rain this evening . 	今天 晚上 会 下雨 。 
you can come with me . 	你 可以 跟 我 来 。 
she has a rose in her hand . 	她 手里 拿 着 一朵 玫瑰 。 
tomorrow is my birthday . 	明天 是 我 生日 。 
his house is across the street . 	他 的 房子 在 街 对面 。 
she gave us a present . 	她 给 了 我们 一个 礼物 。 
i want us to do it together . 	我 想 让 我们 一起 做 。 
he took me for an eng@@ li@@ sh@@ man . 	他 误认为 我 是 一个 英国人 。 
why do n't we get out of here ? 	我们 为什么 不 离开 这里 ？ 
e@@ in@@ ste@@ in loved playing the violin . 	爱因斯坦 喜欢 拉 小提琴 。 
they did n't speak french very well . 	他们 说 法语 说 得 不太好 。 
yes , of course . 	是 的 ， 当然 。 
leaving something un@@ finished is the worst thing you can do . 	半途而废 是 你 所 能 做 的 最 糟糕 的 事情 。 
this dictionary is n't the most recent ver@@ sion . 	这本 字典 不是 最 新版 的 。 
if time permi@@ ts , i 'll visit the museum . 	如果 时间 允许 ， 我会 去 参观 博物馆 。 
he is getting better bit by bit . 	他 一点一点 地变 好 。 
ten years is a long time . 	十年 是 很长 的 时间 。 
they are proud of their daughter . 	他们 以 他们 的 女儿 为荣 。 
she wee@@ ded the garden . 	她 给 花园 除了 草 。 
i 'm as tall as you . 	我 跟 你 一样 高 。 
she 's about the same age as i am . 	她 大约 跟 我 同 年纪 。 
the police seem to know exactly where we are . 	警察 看来 很 清楚 我们 在 哪里 。 
it 's not mine . 	不是 我 的 。 
what 're you doing there ? 	你 在 那里 做 什么 呢 ？ 
wo@@ w ! it 's been a long time . 	哇 ! 好久 不见 了 。 
do n't make fun of old people . 	不要 捉弄 老人家 。 
would you like some more gra@@ vy ? 	你 想 再 来些 酱 汁 吗 ？ 
i do hope you 'll come again . 	我 很 希望 你 会 再 来 。 
his clothes are out of fashion . 	他 的 衣服 过时 了 。 
i 'm not so sure tom is wrong . 	我 不 太 确定 汤姆 错 了 。 
let me handle this . 	让 我 来 处理 。 
the rain is le@@ tting up . 	雨 变小 了 。 
mary is tom 's secretary . 	玛丽 是 汤姆 的 秘书 。 
lie on your right side . 	躺 在 你 右边 。 
i 'm trying to save room for dessert . 	我 尽量 留着 胃 吃 甜点 。 
he can swim very fast . 	他 能 游得 很快 。 
i had a nightmare . 	我 做 噩梦 了 。 
are you being paid for doing this ? 	是 有人 花钱 让 你 做 这事 吗 ？ 
many people work in indu@@ stri@@ al towns . 	许多 人 在 工业 城市 工作 。 
they forced me out . 	他们 迫使 我 出来 。 
she asked a very good question . 	她 问 了 一个 非常 好 的 问题 。 
i slept on the bus . 	我 在 公交车 上 睡觉 了 。 
my parents are n't old yet . 	我 父母 还 不 老 。 
i 'm no longer your assistant . 	我 不再 是 你 的 助手 了 。 
i do n't even want to think about what could happen . 	我 甚至 不想 去 想会 发生 什么 。 
she 's practicing english so she can get a better job . 	她 练习 英语 以 找 更好 的 工作 。 
the sky was completely dark . 	天空 完全 变黑 了 。 
tom is interested in mathematics . 	汤姆 是 对 数学 感兴趣 。 
i did my best . 	我 做 得 好 到 不能 再 好 了 。 
bea@@ ts me . 	我 一无所知 。 
will you show me your passport , please ? 	能否 请 您 给 我 看 一下 您 的 护照 ？ 
a friend of mine came to see me during the day . 	我 的 一个 朋友 在 白天 的 时候 来看 我 。 
if he knew her phone number , he could call her . 	如果 他 知道 她 的 电话 ， 他会 打 给 她 。 
tom 's house has three bed@@ rooms . 	Tom 的 房子 有 三个 房间 。 
i 'll do it . 	我会 做 的 。 
the embassy is located next to the su@@ pre@@ me cou@@ rt . 	大使馆 就 在 最高法院 旁边 。 
actions speak louder than words . 	行动 胜于 雄辩 。 
we must finish our homework first . 	我们 必须 先 完成 我们 的 功课 。 
a great number of citi@@ zens went into the army . 	许多 老百姓 加入 了 军队 。 
his shirt was sta@@ ined with sauce . 	他 的 衬衫 被 酱 汁 弄 脏 了 。 
just relax . 	放松 点 吧 。 
give tom a hand . 	帮 汤姆 一把 。 
she de@@ spi@@ sed him . 	她 看不起 他 。 
he does not like being punished . 	他 不 喜欢 被 惩罚 。 
he is out now . 	他 现在 出去 了 。 
he dropped in at the bookstore . 	他 顺道 去 了 这家 书店 。 
i wanted to stop tom . 	我 想 阻止 汤姆 。 
i 'm starting to dislike her . 	我 开始 不 喜欢 她 了 。 
a famous architect built this house . 	一个 有名 的 建筑师 造 了 这栋 房子 。 
this hotel does n't have a swimming pool . 	这个 酒店 没有 游泳池 。 
there was a lot of snow last winter . 	去年 冬天 下 了 好多 雪 。 
he had a second helping of soup . 	他 又 喝 了 一碗 汤 。 
luc@@ ki@@ ly , we found an escape rou@@ te . 	幸运 的 是 ， 我们 找到 了 逃生 通道 。 
i 'm old enough to live by myself . 	我 年纪 够 大 了 可以 自己 一个 人住 。 
will you mail this letter for me ? 	你 可以 帮 我 寄 这 封信 吗 ? 
you 've already had cake . 	你 已经 把 蛋糕 吃 了 。 
a group of young men are playing hand@@ ball in the pla@@ y@@ ground . 	一群 年轻人 在 操场 上 打 手球 。 
mary said she would do her homework . 	玛丽 说 她 会 做 她 的 功课 。 
our mother bought us a pu@@ ppy . 	我们 的 妈妈 买 了 一只 小狗 给 我们 。 
i wish i had a car . 	但愿 我 有 一辆 车 。 
any@@ way , you 'll never know . 	不管怎样 ， 你 永远 不会 知道 。 
do you think i 'm made of money ? 	你 以为 我造 钱 啊 ？ 
did tom ever tell you how he first met mary ? 	汤姆 告诉 你 他 是 怎样 第一次 遇见 玛丽 的 了 吗 ？ 
do you believe that god exists ? 	你 相信 神 存在 吗 ？ 
she became drow@@ sy after supper . 	晚 饭后 她 变得 昏昏欲睡 。 
i always have to wear a tie because of my job . 	因为 我 这份 工作 的 缘故 ， 我 总是 要 打 领带 。 
do you like shopping ? 	你 喜欢 购物 吗 ？ 
ju@@ pi@@ ter is the largest planet in the solar system . 	木星 是 太阳系 中 最大 的 行星 。 
she is having lunch now . 	她 现在 正在 吃 午餐 。 
he showed me his photograph album . 	他 给 我 看 了 他 的 影集 。 
he had a shower before breakfast . 	他 在 早餐 前洗 了 个 澡 。 
it ser@@ ves you right . 	自作自受 。 
i want to have this letter registered . 	我 想要 用 挂号 寄 这 封信 。 
she must have been sick . 	她 一定 是 生病 了 。 
i use this . 	我 使用 这个 。 
after a couple of drinks , the guy was feeling no pain . 	喝 了 几杯 酒后 ， 这个 家伙 就 感觉 不痛 了 。 
which cup is yours ? 	哪个 杯子 是 你 的 ？ 
i wonder why nobody told me . 	不 知道 为什么 没有 人 告诉 过 我 。 
i do n't like artificial flowers . 	我 不 喜欢 假花 。 
as a matter of fact , i have n't eaten anything since this morning . 	事实上 ， 我 从 今天 早上 开始 没有 吃 任何 东西 。 
we 're just like brothers . 	我们 就 像 兄弟 一样 。 
the problem 's been solved . 	问题 已 解决 。 
you are very brave . 	您 非常 勇敢 。 
you must take his age into account . 	你 该 考虑 他 的 年纪 。 
we did n't bring it back . 	我们 没 把 它 带 回来 。 
i want to show you something in my office . 	我 想 给 你 看看 我 办公室 里 的 一些 东西 。 
i have n't eaten for many days . 	我 好 多天 没 吃 东西 了 。 
are there any english magazines in this library ? 	这间 图书馆 有 任何 英语 杂志 吗 ? 
my problem is i do n't trust you . 	我 的 问题 是 我 不 信任 你 。 
they 're di@@ gging a hole . 	他们 正在 挖 一个 洞 。 
grab this . 	抓住 这个 。 
a friend 's coming over tomorrow . 	一个 朋友 明天 要 过来 。 
she 's busy now and ca n't talk with you . 	她 现在 忙 ， 没有 办法 跟 你们 说话 。 
i have lost my pen . 	我 弄 丢 了 我 的 笔 。 
my father graduated from harvard university . 	我 爸爸 是 哈佛大学 毕业 的 。 
i will say something about it . 	我会 谈谈 它 。 
be careful with it . 	当心 它 。 
i almost laughed out loud . 	我 差点 大声 笑 了 出来 。 
this chair is ug@@ ly . 	这 把 椅子 很 丑 。 
it 's not possible to stop here . 	在 这 停留 ， 这 不 可能 。 
i thought his opinion was re@@ lev@@ ant . 	我 认为 他 的 意见 很 中肯 。 
doctors refused to per@@ form a second operation . 	医生 们 拒绝 做 第二次 手术 。 
is this your car ? 	这 是 你 的 车 吗 ? 
i did nothing out of the ordinary . 	我 没 做 不 寻常 的 事 。 
tom is old enough to go to school . 	汤姆 年纪 足够 去 上学 了 。 
thanks for your quick answer . 	谢谢 您 的 迅速 回复 。 
banks charge high@@ er interest on lo@@ ans to ri@@ sky customers . 	银行 对 风险 客户 收取 较 高 的 贷款 利息 。 
tom often goes cro@@ ss@@ -@@ country skiing . 	Tom 经常 滑雪 穿过 城市 。 
what 's the meaning of this word ? 	这个 字 的 意思 是 什么 ？ 
i work every day except sunday . 	除了 星期天 我 每 一天 都 工作 。 
put away your books and note@@ books . 	把 你 的 书 和 笔记本 收 起来 。 
please help me . 	请 帮助 我 。 
he has an eye for anti@@ qu@@ es . 	他 对 古董 很 有 鉴赏力 。 
there 's no way to win . 	没有 办法 赢 。 
that was really boring . 	那 真是 无聊 。 
since i had met him once before , i recognized him right away . 	由于 我 以前 见 过 他 一次 ， 所以 我 马上 就 认出 他 了 。 
what do you suppose this could be ? 	你 认为 这是 什么 ？ 
put hand@@ cu@@ ff@@ s on him . 	把 他 铐 上 。 
the wind is cold today . 	今天 刮 冷风 。 
actually , i 'm not sugg@@ est@@ ing anything . 	实际上 ， 我 没有 建议 甚么 。 
we 're in a hurry . 	我们 很 匆忙 。 
please keep this secret . 	请 保守 这个 秘密 。 
i 'll give you this money . 	我会 给 你 这笔 钱 。 
do you like playing volleyball ? 	你 喜欢 打 排球 吗 ？ 
everybody knows that he is honest . 	大家 都 知道 他 是 诚实 的 。 
osaka is the center of com@@ mer@@ ce in japan . 	大坂是 日本 的 商业 中心 。 
a change of air will do you a lot of good . 	改变 环境 将 对 你 有 很多 好处 。 
i really need to read all this . 	我 真的 需要 把 这 都 读 了 。 
i 'm not guilty of anything . 	我 没有 对 任何 事 感到 有罪 。 
he runs as fast as you . 	他 跑 得 跟 你 一样 快 。 
i 'm always forgetting people 's names . 	我 总是 忘记 别人 的 名字 。 
there is nothing worse than doing something in a hal@@ f-@@ hear@@ ted man@@ ner . 	没有 什么 比 做事 缺乏 热情 更 糟 。 
i 'm married . 	我 结婚 了 。 
i 'd be happy to help you . 	我 愿意 帮 你 。 
people are counting on us . 	人们 正在 依赖 着 我们 。 
you must be back by 10 o'clock . 	你 必须 在 10 点前 回来 。 
our house was robbed while we were away . 	我们 走开 的 时候 ， 房子 被 盗窃 了 。 
she said that she was ill . 	她 说 她 病 了 。 
the car is n't worth repa@@ ir@@ ing . 	这车 不 值得 修 了 。 
there are many s@@ lu@@ ms in mexico . 	在 墨西哥 有 很多 贫民窟 。 
she must be over eighty . 	她 肯定 超过 80 岁 了 。 
i 'm going to lose . 	我要 输 了 。 
do you promise ? 	你 保证 ？ 
do you have school on saturdays ? 	你 星期六 要 上学 吗 ？ 
she came home very late . 	她 很 晚 回家 。 
i do n't have to clean my room . 	我 不用 打扫 房间 。 
he was se@@ v@@ ere with his children . 	他 对 自己 的 孩子 很 严格 。 
be careful . it 's very sharp . 	小心 点 ， 它 很 锋利 。 
i said to myself , `` that 's a good idea . '' 	我 对 自己 说 ， “ 那 是 个 好 主意 。 ” 
tom was dressed like a pi@@ rate . 	Tom 穿 得 像 个 海盗 。 
the lan@@ d@@ l@@ or@@ d says he wants to raise the rent . 	地主 说 他 要 提高 租金 。 
why do you work here ? 	你 为什么 在 这儿 工作 ？ 
i have no idea who she is . 	我 不 知道 她 是 谁 。 
it is two miles from here to the park . 	从 这里 到 公园 距离 两 英里 。 
this p@@ ear smells nice . 	这 只梨闻 上去 很香 。 
the accident 's only survi@@ vor was a baby . 	这场 灾难 的 唯一 幸存者 是 一个 婴儿 。 
i wish i could buy that guitar . 	但愿 我 可以 买 那 把 吉他 。 
it 's time to talk . 	到 谈话 的 时间 了 。 
he graduated from high school this spring . 	今年 春天 他 从 高中 毕业 了 。 
as soon as he saw me , he ran away . 	他 一 看见 我 ， 就 跑 了 。 
mary paid five dollars for her lunch . 	玛丽 用 5 美元 买 了 午饭 。 
english is too difficult for me to understand . 	英语 对 我 来说 太难 理解 了 。 
i heard it on the radio . 	我 从 广播 中 听到 它 。 
tom did n't let me answer mary 's question . 	汤姆 没有 让 我 回答 玛莉 的 问题 。 
what 's going on with you ? 	你 怎么 了 ？ 
would you mind opening the window ? 	你 介意 打开 窗户 吗 ? 
we just need a plan . 	我们 只是 需要 个 计划 。 
how many things did you buy ? 	你 买 了 多少 东西 ？ 
switzerland is a beautiful country . 	瑞士 是 一个 美丽 的 国家 。 
why did n't you bring your hat today ? 	为什么 你 今天 没有 把 帽子 带来 ？ 
you 'll love it . 	你 会 爱 它 。 
the present time is a good time . 	现在 正是 好 时候 。 
she finally made it . 	她 终于 做到 了 。 
we saw him walking across the street . 	我们 看见 他 正在 过 马路 。 。 
he wants to go to america . 	他 想 去 美国 。 
she may be late , in which case we will wait . 	她 可能 迟到 ， 然后 我们 就要 等 。 
tom sold mary his car . 	汤姆 把 他 的 汽车 卖 给 了 玛丽 。 
that was the first time that i 'd seen tom so angry . 	那 是 我 第一次 见到 汤姆 如此 生气 。 
he att@@ ri@@ bu@@ ted his success to good luck . 	他 把 他 的 成功 归功 于 好运 。 
i could n't enter because the door was closed . 	我 因为 门关 著进 不 去 。 
there are no comments yet . 	还 没有 任何 评论 。 
he bored us with his long stories . 	他 长长的 故事 让 我们 觉得 厌烦 了 。 
i ca n't wait to go on a vacation . 	我 等不及 要 去 度假 。 
tom is on the bus to the city . 	汤姆 搭 公车 去 市区 。 
it is wrong to ch@@ eat at cards . 	玩牌 作弊 是 错误 的 。 
he asked me whether i like math . 	他 问 我 喜不喜欢 数学 。 
how awful ! 	太 可怕 了 。 
i thought he was my brother . 	我 以为 他 是 我 弟弟 。 
which hat is yours ? 	哪顶 帽子 是 你 的 ？ 
tom burst into tears . 	汤姆 泪流满面 。 
books are for people who wish they were somewhere else . 	书 是 为了 那些 希望 自己 在 另 一个 地方 的 人 。 
i understand that you feel un@@ easy , but do n't worry . 	我 知道 你 不 自 在 ， 但别 急 。 
is@@ la@@ m first reached china about the middle of the 7@@ th century . 	伊斯兰教 大约 在 七 世纪 中 传到 中国 。 
i met your girlfriend . 	我见 过 你 的 女朋友 。 
i have n't finished my homework yet . 	我 还 没有 完成 我 的 作业 。 
i 'll gladly pay you anytime . 	我 随时 乐意 付钱 给 你 。 
history is not his major subject . 	历史 不是 他 的 主修 课 。 
his concert was great . 	他 的 演唱会 很棒 。 
i was the last one to see tom . 	我 是 见 汤姆 的 最后 一个 。 
stop making a fool of yourself . 	停止 愚弄 你 自己 。 
the box is too heavy to carry . 	这个 箱子 太重 了 无法 携带 。 
we should be safe here . 	我们 在 这里 应该 是 安全 的 。 
we got behind the car and pushed . 	我们 到 车子 后面 推车 。 
you 've been had . 	您 被 骗 了 。 
keep quiet . 	保持 安静 ！ 
you do n't have to kick yourself . 	你 不要 自甘堕落 。 
why did you stay at home yesterday ? 	你 昨天 为 甚么 在家 ？ 
he took out his passport . 	他 拿出 了 他 的 护照 。 
i studied english when i was there . 	当 我 在 那里 的 时候 ， 我 学习 英语 。 
tom knows the difference . 	汤姆 知道 不同 之处 。 
i 'm very happy to hear about the party . 	我 听到 聚会 的 事 很 高兴 。 
iron the inside of co@@ ll@@ ars first , and then the outside . 	先 熨烫 领子 的 里面 ， 然后 是 外面 。 
we 're still nervous . 	我们 还是 紧张 。 
i did n't go to school last monday . 	上周 一 我 没 去 上学 。 
please serve him his meal first . 	请 先为 他 上菜 。 
come on , hurry up . 	来 吧 ， 快 一点 。 
this room is cleaned by tom . 	这 房间 是 由 汤姆 清扫 的 。 
i know what you meant . 	我 知道 你 是 什么 意思 。 
i ba@@ the once a day . 	我 每天 洗 一次 澡 。 
i 'd like to leave this town and never come back . 	我 希望 离开 这个 村子 并且 再也 不要 回来 。 
a woman visited us while you were sleeping . 	您 睡觉 的 时候 ， 一个 女人 来看 过 我们 。 
where 's my apple juice ? 	我 的 苹果汁 在 哪 ? 
i want to ride a horse . 	我 想 骑马 。 
keep your eyes open . 	睁 大 你 的 眼睛 。 
did n't you hear her speaking french ? 	你 没 听到 她 说 法语 吗 ？ 
he has a nice income . 	他 收入 可观 。 
take a deep breath and then relax . 	深呼吸 ， 然后 放松 。 
tom is serious now . 	汤姆 现在 是 认真 的 。 
she fu@@ mb@@ led with a piece of paper . 	她 摸索 著 一张 纸 。 
he never said that . 	他 从来 没说 过 那个 。 
i played catch with my father . 	我 和 我 爸爸 玩 接球 。 
we had a heavy rain last night . 	昨晚 下 了 一场 大雨 。 
i love her . 	我 爱 她 。 
i 'm sure they can hear us . 	我 确定 他们 能 听见 我们 的 声音 。 
i do n't think you ought to . 	我 认为 你 不 应该 。 
nobody should be worried . 	没人 应该 担心 。 
tom kissed mary on the cheek . 	汤姆 亲 了 玛丽 脸颊 。 
this clock is mine . 	这个 表是 我 的 。 
you have n't changed at all . 	你 真的 一点 没变 。 
my father works at a factory . 	我 父亲 在 工厂 工作 。 
my mother opened the door very carefully . 	我 妈妈 小心翼翼 地 打 开门 。 
she always gets her own way . 	她 总是 随心所欲 。 
if you hurry , you will catch up with him . 	如果 你 快 一点 ， 还 能 赶上 他 。 
the truth is that nothing is totally true or false . 	真相 是 没有 甚么 完全 正确 或 错误 。 
it 's a very serious illness . 	这 是 很 严重 的 病 。 
what does this stand for ? 	这是 什么 意思 ？ 
my head is explo@@ ding . 	我 的 头 要 炸 了 。 
it seems less crowded during the week . 	平日 似乎 比较 不 拥挤 。 
the japanese mi@@ li@@ tary for@@ ces seemed too strong to stop . 	日本 军队 看来 强大 得 不可 阻挡 。 
she is good at speaking english . 	她 擅长 说 英文 。 
i understand it more or less . 	我 大概 懂 了 。 
he 's not brea@@ king the law . 	他 没 违法 。 
i bought her a watch . 	我 买 了 一支 手表 给 她 。 
were you expecting to win ? 	你 打算 赢 吗 ？ 
my camera is different from yours . 	我 的 相机 跟 你 的 不同 。 
he owes his success to good luck . 	他 将 他 的 成功 归于 好运 。 
she was not in the mood for lunch . 	她 不想 吃 午饭 。 
my father does n't like soccer . 	我 爸爸 不 喜欢 足球 。 
he had to stay in bed . 	他 得 卧床 休息 . 
who is that person ? 	那人 谁 啊 ？ 
i do n't want to play cards . 	我 不想 玩 纸牌 。 
we are to be married next sunday . 	我们 将 于 下 周日 结婚 。 
why did you marry tom ? 	你 为 甚么 跟 汤姆 结婚 ？ 
my brother is good at mathematics . 	我 哥哥 擅长 数学 。 
she was too short to see over the fence . 	她 太 矮 了 ， 看不到 围墙 外面 。 
here 's where they usually have dinner . 	这儿 是 他们 通常 吃 晚饭 的 地方 。 
you nearly po@@ ked me in the eye with your pencil . 	你 的 铅笔 差点 戳 到 我 的 眼睛 了 。 
it 's easy for monkeys to climb trees . 	猴子 爬树 容易 。 
i have more experience than tom . 	我 比 汤姆 更 有 经验 。 
take off your hat when you enter a classroom . 	进 教室 的 时候 请 把 帽子 摘 了 。 
why is the sky blue ? 	为什么 天是 蓝 的 ？ 
she gave me plenty to eat . 	她 给 了 我 很多 吃 的 东西 。 
i go to church on sunday . 	周日 我 去 做礼拜 。 
the old man star@@ ved to death . 	这位 老人 饿死 了 。 
maybe you should study harder next time . 	你 下回 可能 该 更 努力 学习 。 
my boss as@@ signed the hard job to me . 	我 老板 把 艰巨 的 任务 指派 给 了 我 。 
i like listening to po@@ p music . 	我 想要 听 流行 音乐 。 
it looks like it 's going to snow . 	看起来 快 下雪 了 。 
we are badly in need of food . 	我们 非常 需要 食物 。 
i think tom is getting ready . 	我 认为 汤姆 准备 好 了 。 
is this your first time in korea ? 	你 是 第一次 来 韩国 吗 ？ 
this dictionary is mine . 	这本 字典 是 我 的 。 
he is good at baseball . 	他 垒球 打得 很 好 。 
he 's a friend of my brother 's . 	他 是 我 弟弟 的 一个 朋友 。 
every dog has his day . 	凡人 皆 有 得意 时 。 
you 've done a lot . 	你 做 了 很多 。 
she looks unhappy . 	她 看起来 不 快乐 。 
he wei@@ gh@@ s a lot more than before . 	他 比 以前 重得 多 。 
you can drive a car , ca n't you ? 	你 会 开车 ， 不是 吗 ? 
how many different kinds of pizz@@ as are on the menu ? 	菜单 上 有 多少 种 比萨 ？ 
please call the fire department . 	请 叫 消防 员 。 
we worked on a farm last summer . 	我们 去年 夏天 在 一个 农场 上 工作 。 
later he wrote to the president . 	他 后来 写信 给 总统 。 
her mother always accompani@@ es her . 	她 母亲 一直 陪 着 她 。 
you can always count on tom . 	你 可以 永远 信赖 汤姆 。 
we will only con@@ sent on that condi@@ tion . 	我们 只会 在 那样 的 条件 下 同意 。 
what on earth are you talking about ? 	你 到底 在 谈 什么 ? 
is it always a s@@ in to tell a lie ? 	说谎 总是 一种 罪 吗 ？ 
i do n't know whether she will come . 	我 不 知道 她 是否 会来 。 
it is difficult for me to answer the question . 	这个 问题 对 我 来讲 很难 回答 。 
when did you begin studying english ? 	你们 什么 时候 开始 学 英语 的 ？ 
tom has a very friendly smile . 	汤姆 有 很 友好 的 微笑 。 
tom did n't take his shoes off . 	汤姆 没脱 鞋 。 
she wants a new dress badly . 	她 很 想要 一条 新 的 连衣裙 。 
you 're a beautiful young woman . 	你 是 一个 美丽 的 女孩 。 
do n't be late for school again . 	不要 再 上学 迟到 了 。 
tom was re@@ placed by mary . 	汤姆 被 玛丽 替换 下来 。 
do you offer any all@@ -@@ day to@@ urs ? 	你 提供 任何 全日 游 吗 ？ 
you wo n't need it . 	你 不会 需要 它 。 
it 's business . 	公事公办 。 
he said hello to the woman . 	他 向 那位 女士 问好 。 
have you had your eyesight checked recently ? 	你 最近 检查 视力 了 吗 ？ 
he 's not a hero . 	他 不是 英雄 。 
the policeman was drunk . 	警察 醉 了 。 
fan@@ cy meeting you here ! 	想不到 会 在 这里 遇见 你 ！ 
what else have you figured out ? 	你 还 发现 什么 了 ？ 
i need help . 	我 需要 帮助 。 
i just wanted to speak to tom . 	我 只 想 跟 汤姆 说话 。 
are you finished with your work ? 	你 完成 你 的 工作 了 吗 ? 
call me if you need anything . 	需要 什么 就 给 我 打电话 。 
i clapped my hands . 	我 拍手 。 
the apple does n't fall far from the tree . 	苹果 掉落 的 地方 不会 离 树干 很远 。 
what did you find out ? 	你 发现 了 甚么 ？ 
i want to go to america someday . 	有 一天 我要 去 美国 。 
what do tigers eat ? 	老虎 吃 什么 东西 ？ 
i had difficulty working out the problem . 	我 在 解决 这个 问题 上 有 困难 。 
how did you arrive at this conclu@@ sion ? 	你们 怎么 得出 这个 结论 的 ？ 
do you really believe that 's what happened ? 	你 真的 相信 那 发生 了 吗 ？ 
i 'll return at 6@@ :30 . 	我 六点 半 回来 。 
drive cau@@ ti@@ ously . 	安全 地 驾驶 。 
`` he 'd like to have a coffee after work . '' `` i would too . '' 	" 他 想 在 下 班后 喝杯 咖啡 。 " " 我 也 想 。 " 
his mother sat up all night waiting for her son . 	他 的 妈妈 坐 了 一 整夜 ， 等 她 的 儿子 。 
ask him his name . 	问 他 一下 他 的 名字 。 
i look forward to your next visit . 	我 期待 著 您 的 再次 光临 。 
i phone him every day . 	我 每天 都 给 他 打电话 。 
i 'm not serious . 	我 不是 认真 的 。 
why am i still here ? 	为什么 我 还 在 这里 ？ 
it was getting dark . 	天要 黑 了 。 
tom swims very fast . 	汤姆 游泳 游得 非常 快 。 
none of my friends drink coffee . 	我 的 朋友 都 不 喝 咖啡 。 
i hope everything goes well . 	我 希望 万事如意 。 
he 's writing a long letter . 	他 写 长信 。 
we should run some te@@ sts . 	我们 应该 进行 测试 。 
i had a good sleep last night . 	我 昨晚 睡得 很 好 。 
we almost had tom convinced . 	我们 差不多 说服 Tom 了 。 
who is this boy ? 	这个 男孩 是 谁 ？ 
anybody can make a mistake . 	谁 都 会 犯错 。 
i 'm a member of the swimming club . 	我 是 游泳 社的 成员 。 
be happy for me . 	为 我 感到 高兴 吧 。 
why should it be different ? 	为什么 它 应该 要 变得 不 一样 ？ 
he is on goods terms with all of his classmates . 	他 和 他 所有 的 同学 相处 融洽 。 
a glass of wine , please . 	一杯 葡萄酒 ， 谢谢 。 
several dozen young people participated in the demon@@ stration . 	几十个 年轻人 参加 了 示威 游行 。 
i had a hard day . 	我过 了 难挨 的 一天 。 
it seems that he knows everything . 	他 似乎 什么 都 知道 。 
i am very interested in these stories . 	我 对 这些 故事 很 感兴趣 。 
please continue . 	请 继续 。 
i have a daughter . 	我 有 一个 女儿 。 
who is your teacher ? 	谁 是 你 老师 ？ 
we hope a solution is found . 	我们 希望 找到 解决 方法 。 
i changed trains at tokyo station . 	我 在 东京 站 换 火车 。 
can you come ? 	你 能 来 吗 ？ 
go at once , o@@ ther@@ wise you will be late . 	立刻 走 ， 否则 你 会 迟到 。 
he is old enough to drive a car . 	他 的 年纪 可以 开车 了 。 
she has a lot of english books . 	她 有 很多 英 文书 。 
i 'll call you on monday . 	我会 在 星期一 给 你 打电话 。 
she has lost weight . 	她 的 体重 减轻 了 。 
who will you vote for for president ? 	你 选 谁 当 总统 ？ 
tom showed us his new car . 	汤姆 给 我们 看 他 的 新车 。 
come in . 	进来 。 
it 's possible that you do n't know this . 	你 有 可能 不 知道 这事 。 
ma@@ ss produ@@ ction redu@@ ced the price of many goods . 	大量 生产 降低 许多 商品 的 价格 。 
you must do your best . 	你 必须 做到 最好 。 
she gave the bl@@ ouse a quick wash . 	她 很快 地 把 衬衫 洗一洗 。 
some boys came into the classroom . 	有些 男孩 走进 了 教室 。 
do you have a car ? 	您 有 车 吗 ？ 
we gave our mother a watch . 	我们 给 了 母亲 一支 手表 。 
true friendship is bas@@ ed on mu@@ tual trust . 	真正 的 友谊 建立 在 彼此 信任 的 基础 上 。 
i left it on the table . 	我 把 它 留在 桌上 了 。 
he caught them stealing apples . 	他 抓 到 了 他们 在 偷 苹果 。 
i agreed to the proposal . 	我 同意 这项 建议 。 
how long have you lived in boston ? 	你 在 波士顿 住 了 多久 ？ 
i just ate sushi and drank beer . 	我 刚才 吃 了 寿司 喝 了 啤酒 。 
you 'd better eat something . 	你 最 好吃 点 东西 
this dog was born two months ago . 	这 只 狗 是 两个 月 前 出生 的 。 
give tom any help you can . 	给予 汤姆 一些 你 力所能及 的 帮助 。 
we 're very disappointed in you . 	我们 对 你 很 失望 。 
the pain has started to ease now . 	痛 开始 减轻 了 。 
he is determined to go to england . 	他 决心 去 英国 。 
who is next ? 	下 一个 是 谁 ？ 
what he said is not true . 	他 说 的话 不是 真的 。 
who is this , please ? 	请问 这 是 谁 ？ 
tom has no time . 	汤姆 没有 时间 。 
you 're not too late . 	你 还 不太晚 。 
he wrote to me yesterday . 	昨天 他 写信 给 我 。 
he is to come to my house tonight . 	他 今晚 会来 我家 。 
you 're sick ! 	你 有 病 ！ 
my hobby is playing the piano . 	我 的 嗜好 就是 弹 钢琴 。 
every great writer seems to have been interested in english . 	每 一个 伟大 的 作家 似乎 已经 对 英语 感兴趣 。 
i spent twelve hours on the train . 	我 在 火车 上待 了 12 小时 。 
almost everyone in our village is related to one another . 	我们 村里 所有 的 村民 几乎 彼此 都 是 亲戚 。 
how 's everything at work ? 	工作 怎么样 ？ 
`` i do n't want to go right now . '' `` why not ? '' 	" 你 现在 不要 出去 。 " " 为什么 不要 ? " 
tom is very much alone . 	汤姆 非常 孤单 。 
clean your room . 	清扫 你 的 房间 。 
he asked me a question . 	他 问 了 我 一个 问题 。 
i could n't leave tom . 	我 不能 离开 汤姆 。 
i want to become rich . 	我想变 有钱 。 
do n't he@@ si@@ tate to ask questions . 	不要 犹豫 去 问 问题 。 
you 're in my way . 	你 挡住 了 我 的 路 。 
how are things at school ? 	学校 怎么样 ？ 
i 'm sorry , i did n't hear you . 	对不起 ， 我 没有 听见 你 说话 。 
i dreamed about you . 	我梦到 你 了 。 
please have someone else do it . 	请 让 别人 去 做 。 
is the bath clean ? 	浴室 干净 吗 ？ 
that hurts . 	真疼 。 
i do n't know . what do you think ? 	我 不 知道 。 你 怎么 想 ？ 
that was the first time that a man walked on the moon . 	那 是 人类 第一次 在 月球 上 行走 。 
everybody lies . 	每个 人 都 会 说谎 。 
i do n't want you . 	我 不 想要 你 。 
we do n't have too much time . 	我们 没有 太多 时间 。 
i want you to not go to boston with tom . 	我要 你 别 和 汤姆 去 波士顿 。 
tom is too tired to help you do that today . 	汤姆 今天 太累 ， 不能 帮 你 。 
they were all dressed in uni@@ for@@ ms . 	他们 全部 穿 制服 了 。 
i 'm not the boss . 	我 不是 老板 。 
he promised to come , but he did n't come . 	他 保证 过会来 却 没有 来 。 
tom , i want to have a chat with you . 	Tom ， 我 想 和 你 谈谈 。 
i will give you this book . 	我会 把 这 本书 给 你 。 
you 're a good lea@@ der . 	你 是 个 好 的 领导人 。 
sit tight . 	耐心 等 着 。 
i ate breakfast in my pa@@ ja@@ mas . 	我 穿 著 睡衣 吃 早饭 。 
she kept me waiting for 30 minutes . 	她 让 我 等 了 半 小时 。 
how much does it cost ? 	多少 钱 ? 
the children were playing in the dirt . 	孩子 们 在 尘土 里 游戏 。 
i appro@@ ved it . 	我 同意 它 。 
science has changed my life . 	科学 改变 了 我们 的 生活 。 
sorry , can i borrow it for a minute ? 	不好意思 ， 可以 借过 一下 吗 ？ 
you do n't know how worried i am . 	你 不 知道 我 有 多 担心 啊 。 
the man is eating bread . 	这个 男人 在 吃 面包 。 
go when you want . 	你 想 走 的 时候 就 走 吧 。 
i do n't remember anything about the incident . 	我 不 记得 事故 的 情况 。 
can we trust them ? 	我们 能 信任 他们 吗 ？ 
what kind of wine do you have ? 	您 有 什么样 的 葡萄酒 ？ 
are they students ? 	他们 是 学生 吗 ？ 
i 've just finished breakfast . 	我刚 吃 完 了 早饭 。 
it is also a good movie . 	它 也 是 部好 电影 。 
i ca n't find my ticket . 	我 找 不到 我 的 票 。 
`` the good die young '' is an old saying which may or may not be true . 	“ 好人 不 长命 ” 是 句 或 真 或 假 的 老话 。 
i ca n't put up with his ar@@ rog@@ ance . 	我 不能 忍受 他 的 傲慢 。 
i have no regrets about what i did . 	我 对 我 做 过 的 事 不 后悔 。 
i have n't eaten lunch yet . 	我 现在 还 没有 吃 过 午饭 。 
get out ! 	出去 ！ 
it might rain . 	可能 会 下雨 。 
you do n't need to carry lunch with you . 	你 不 需要 随身 带著 午餐 。 
he does nothing but complain from morning till night . 	他 从早到晚 只是 在 抱怨 。 
the ship was flying the american flag . 	这艘 船 挂 著 美国 国旗 。 
i want you to sleep on it . 	我 想要 你 睡 在 它 上边 。 
tom could n't tell mary everything he knew . 	汤姆 不能 告诉 玛丽 他 知道 的 所有 事 。 
i 'll carry this suitcase for you . 	我会 帮 你 提 这个 手提箱 。 
the village has no electricity . 	村里 没 通电 。 
tom did it the same way i did . 	汤姆 我 按 我 做 的 办法 做 了 。 
i did n't really feel like going out . 	我 不是 很想 出去 。 
foo@@ ls rush in where ang@@ els fear to t@@ read . 	天使 畏惧 处 , 愚人 敢 闯入 。 
hold your horses , young man . 	握住 你 的 马 ， 年轻人 。 
excuse me . do you speak english ? 	对不起 。 你 会 讲 英语 吗 ？ 
take the first street to the right . 	第一条 街右 转 。 
the youngest daughter is excep@@ tion@@ ally beautiful . 	么 女长 得 特别 漂亮 。 
people who will lie for you , will lie to you . 	会为 你 说谎 的 人 ， 就 会 对 你 说谎 。 
i want some orange juice . 	我 想要 一点 柳 橙汁 。 
i 've never heard of this ac@@ tor . 	我 从没 听说 过 这个 演员 。 
how much sugar do you use ? 	你 用 多少 糖 ？ 
are n't you the one who saved me ? 	你 不是 救 了 我 的 人 吗 ？ 
tom studies at harvard . 	汤姆 在 哈佛 学习 。 
i thought pizza was what you wanted to eat . 	我 认为 你 想 吃 的 是 比萨 。 
this is where i want to live for the rest of my life . 	这里 是 我 余生 想待 的 地方 
i 'm very glad to see you again . 	我 很 高兴 再次 见到 你 。 
he calls her up every night . 	他 每天 晚上 打电话 给 她 。 
i wonder if this is love . 	我 不 知道 这 是不是 爱 。 
stop looking for problems , tom . 	别 找事 ， 汤姆 。 
some people pur@@ sue only pleasure . 	有些 人 只 追求 快乐 。 
i do not want any milk at all . 	我 完全 不要 牛奶 。 
the impor@@ tation of rare wild animals to this country is strictly prohibited . 	该国 严禁 进口 稀有 野生 动物 。 
i like tennis and golf . 	我 喜欢 打 网球 和 高尔夫球 。 
we visited the museum last week . 	我们 上周 参观 了 博物馆 。 
i do n't like to swim in the pool . 	我 不 喜欢 在 泳池 里 游泳 。 
the patient is steadily re@@ cover@@ ing . 	该 病人 正 逐步 康复 。 
england is proud of her poe@@ ts . 	英格兰 为 她 的 诗人 感到 自豪 。 
the de@@ sign itself is fla@@ wed . 	设计 本身 有 问题 。 
put on your good shoes . 	穿 上 你 的 好 鞋 。 
one of my suit@@ ca@@ ses is missing . 	我 的 其中 一个 行李 不见 了 。 
i promise . 	我 向 你 保证 。 
it 's next to impossible to finish it in a day . 	在 一天 之内 完成 它 几乎 是 不 可能 的 。 
tom began talking . 	汤姆 开始 说话 。 
you 've done what you needed to do . 	你 已经 尽力 了 。 
please put those chairs away . 	请 把 那些 椅子 放好 。 
what do you want to be ? 	您 想 成为 什么 ？ 
they do n't have to know . 	他们 不 需要 知道 。 
now i need you to leave . 	现在 我 需要 你 离开 。 
would you please come again later ? 	请 您 稍后 再来 好 吗 ？ 
thanks to a cold summer , beer has sold po@@ or@@ ly . 	多亏 了 冷夏 ， 啤酒 卖 的 不好 。 
we were just about to enter the room . 	我们 正要 进 房间 。 
the boy can count to ten . 	这小 男孩 能数 到 十 。 
bring it to me . 	把 它 带给 我 。 
japan re@@ lies on ar@@ a@@ b countries for oil . 	日本 靠 阿拉伯 国家 提供 石油 。 
most americans do not ob@@ ject to my calling them by their first names . 	大多数 美国 人 似乎 不 反对 我 直呼 其名 。 
rather than live a hundred years as a rabbit , live one day as a tiger . 	宁可 当 只 老虎 活 一天 ， 也 不愿 当 只 兔子 过 一百年 。 
tom plays chess very well . 	汤姆 下棋 下得 很 好 。 
it might be a wedding . 	这 可能 是 一场 婚礼 。 
they made him sign the contract . 	他们 让 他 签约 了 。 
this room has air condition@@ ing . 	这个 房间 有 空调 。 
you do n't need a gun . 	你 不 需要 枪 。 
it is already past five o'clock . 	已经 过 了 五点 钟 。 
tom 's parents were both teachers . 	汤姆 的 父母 都 是 教师 。 
i 'll miss your cooking . 	我会 想念 你 的 厨艺 。 
he came to pick me up . 	他来 接 我 走 。 
we did it ourselves . 	我们 自己 做 的 。 
which book is yours ? 	哪 本书 是 您 的 ？ 
i was learning . 	我 在 学习 。 
tom wanted to be a better teacher . 	汤姆 想 做 个 更好 的 教师 。 
i think i have a question . 	我觉 的 有 一个 问题 。 
i never thought something like that could happen . 	我 从来 没想到 会 发生 那种 事 。 
tom 's coa@@ ch likes him . 	汤姆 的 教练 喜欢 他 。 
where is the problem ? 	哪里 有 问题 ? 
what did you do with those books ? 	你 用 那些 书 做 什么 ？ 
everybody laughs . 	每个 人 都 在 笑 。 
she did n't think so . 	她 不 这么 想 。 
you should have introduced yourself to the girl . 	你 应该 向 那个 女孩 自我 介绍 的 。 
why did you buy such an expensive dictionary ? 	为什么 你 买 了 一本 那么 贵 的 词典 ？ 
she is busy preparing supper now . 	她 现在 正忙 著 准备 晚饭 。 
tom ca n't ride a horse . 	汤姆 不能 骑马 。 
why are n't you coming with us ? 	你 为什么 不 和 我们 一 起来 ？ 
i think we 've found what we were looking for . 	我 认为 我们 找到 我们 正在 找 的 东西 了 。 
dead men tell no tal@@ es . 	死人 不会 告密 。 
i saw him cross the street . 	我 看见 他 穿过 了 马路 。 
who hired you ? 	谁 雇 了 你 ？ 
it has nothing to do with me . 	它 跟 我 没关系 。 
the dress suits you very well . 	这条 裙子 很 适合 你 。 
i need a friend . 	我 需要 个 朋友 。 
please say it once more . 	请 再说 一次 。 
how do you account for that ? 	你 怎么 解释 那个 ？ 
do you believe in fai@@ ries ? 	你 相信 神话 传说 吗 ？ 
we were just talking about you when you called . 	当 你 打电话 来时 , 我们 正在 谈论 你 。 
he does n't always come late . 	他 不是 总来 晚 。 
i 'm looking over his report . 	我 在 阅读 他 的 报告 。 
some furniture is put together with glu@@ e . 	一些 家具 是 用 胶水 黏 在 一起 。 
let 's go out and have some fun tonight . 	我们 今晚 一起 出去 找 乐子 吧 。 
i 'll get in touch with you soon . 	我会 很快 跟 你 联络 。 
no one is calling you a thief . 	没人 叫 你 小偷 。 
i cleared the table . 	我 清理 了 桌子 。 
she lives just across from us . 	她 就 住 在 我们 对面 。 
my father likes traveling by air . 	我 父亲 喜欢 搭 飞机 旅行 。 
there are many stor@@ es in this area . 	这个 区域 有 很多 商店 。 
i often played tennis with her . 	我 常常 和 她 打 网球 。 
what 's with you ? 	你 怎么 了 ？ 
this meal is a@@ de@@ qu@@ ate for three . 	这饭 足够 三个 人 吃 。 
i won the lottery . 	我 中奖 了 。 
all my friends will be there . 	我 所有 的 朋友 都 会 到 那儿 。 
money ca n't buy everything . 	金钱 不能 买到 所有 的 东西 。 
i 'll tell you the truth . 	我会 告诉 你 真相 。 
have you worked the puzz@@ le out ? 	你 解开 谜团 了 吗 ？ 
my father has five siblings . 	我 父亲 有 五个 兄弟 姐妹 。 
who were you speaking with ? 	你 和 谁 说话 呢 ？ 
the child followed me to the park . 	这 孩子 跟 著 我 去 公园 。 
i received a letter three months later . 	我 在 三个 月 后 收到 了 一 封信 。 
tom did a good job predi@@ cting who would win the ele@@ ction . 	汤姆 预测 胜选者 做 得 好 。 
who is that woman holding the flowers ? 	那个 拿 着 花 的 女人 是 谁 ？ 
what 's your nick@@ name ? 	你 的 昵称 是 甚么 ？ 
she sells flowers . 	她 卖花 。 
is she your mother ? 	她 是 你 妈妈 吗 ? 
he is n't my brother . he 's my cousin . 	他 不是 我 的 兄弟 。 他 是 我 的 表弟 。 
the boy did n't change his opinion . 	这个 男孩 没有 改变 他 的 意见 。 
i 'm afraid i must say goodbye . 	恐怕 我 必须 说 再见 了 。 
i want you out of my room . 	我 想 让 你 离开 我 的 房间 。 
a little walk will give you a good appetite for breakfast . 	散散步 将会 给 你 很 好 的 食欲 吃 早餐 。 
do you like school ? 	你们 喜欢 学校 吗 ？ 
i would n't buy that for tom . 	我 不会 给 汤姆 买 那 东西 。 
she showed him the photo . 	她 把 照片 给 他 看 。 
do you want any of these books ? 	你 要 这些 书中 的 任何 一本 吗 ？ 
what would the world be like without women ? 	没有 女人 的话 ， 世界 会 是 什么样 ？ 
the bath@@ tub was filled with hot water and flower pe@@ tals . 	浴缸 里 满 是 热水 和 花瓣 。 
i did n't know what to do . 	我 不 知道 要 做 什么 。 
he thought that it was like a bird ca@@ ge . 	他 认为 这像 个 鸟笼 。 
how long will the meeting last ? 	会议 持续 多久 ？ 
i 'm surprised that you do n't know about their marriage . 	我 很 惊讶 ， 你 竟然 不 知道 他们 结婚 。 
that is no business of his . 	那不关 他 的 事 。 
i arrived in kobe around two thirty . 	我 在 两点 半左右 到达 神户 。 
where in turkey do you live ? 	你 在 土耳其 哪儿 生活 ? 
every time i read the bi@@ ble , i am deeply moved . 	每次 我读 圣经 都 会 被 深深地 感动 。 
we must try to break the dea@@ d@@ lock . 	我们 必须 设法 打破 这个 僵局 。 
do n't leave the water running . 	不要 让 水 一直 流 。 
now , what do you want me to do ? 	现在 ， 你 想 让 我 怎么 做 ？ 
i have a certain amount of money on me . 	我 有些 钱 。 
there is a clock on the wall . 	墙壁 上 挂 著 一个 时钟 。 
have you ever seen such a beautiful sun@@ set ? 	你 看过 这么 美 的 夕阳 吗 ? 
wine made here is very famous . 	这里 制造 的 葡萄酒 非常 有名 。 
i did n't feel bad . 	我 没 觉得 不好 。 
he applied himself to the study of music . 	他 潜心 研究 音乐 。 
can we talk in private ? 	我们 能 私下 谈谈 吗 ？ 
we should b@@ an adverti@@ sing a@@ imed towards children . 	我们 应该 禁止 针对 儿童 的 广告 。 
there is one apple on the desk . 	书桌 上 有 一个 苹果 。 
what did you have for lunch ? 	你 午饭 吃 的 什么 ？ 
you did n't write anything . 	你 甚么 也 没 写 。 
do n't look at tom . look at me . 	不要 看 汤姆 。 看著 我 。 
i 'll let tom tell you . 	我会 让 汤姆 告诉 你 。 
we must take into account the wishes of all the family in planning a trip . 	筹划 旅行 的 时候 ， 我们 必须 考虑 到 全家人 的 意愿 。 
he became a member of this club five years ago . 	他 在 五年 前 成为 了 这个 俱乐部 的 成员 。 
you may not remember me , but i remember you . 	你 可能 不 记得 我 了 ， 但 我 记得 你 。 
the air felt a little cold . 	空气 有点 冷 。 
tom finally did something right . 	汤姆 最终 做 了 点 正确 的 事 。 
three months is too short a time to finish the experiment . 	要 完成 实验 ， 三个 月 太 短 了 。 
there are no chairs in this room . 	这个 房间 里 没有 椅子 。 
we can see more and more s@@ wal@@ lows . 	我们 能 看到 越来越 多 的 燕子 。 
she had to accept her fa@@ te . 	她 该 接受 她 的 命运 。 
he looks older than my brother . 	他 看起来 年纪 比 我 的 兄弟 大 。 
tom does n't want to talk about it . 	汤姆 不想 谈 这件 事 。 
we 're in a hurry . 	我们 很急 。 
tom is more famous than you . 	汤姆 比 你 有名 。 
he is a doctor by profession . 	他 的 职业 是 医生 。 
do you subscribe to any magazines ? 	你 有 订阅 任何 杂志 吗 ？ 
you do n't need to do this . 	你 不 需要 做 这事 。 
i think you 're really ama@@ zing . 	我 觉得 你 真是 让 人 大吃一惊 。 
i ca n't imagine life without you . 	我 无法 想像 没有 你 的 生活 。 
that 's a huge cha@@ ll@@ en@@ ge . 	这是 一个 巨大 的 挑战 。 
it 's a good deal . 	这是 一笔 不错 的 交易 。 
i know that it 's hard to believe . 	我 知道 ， 要 相信 这件 事 很 难 。 
she kept me waiting for 30 minutes . 	她 让 我 等 了 30 分钟 。 
what do you think i 've been doing ? 	你 觉得 我 之前 在 做 什么 ？ 
no one came except mary . 	除了 玛丽 没有 人来 。 
one of them is a sp@@ y . 	他们 其中 一人 是 间谍 。 
she 's just a child . 	她 只是 个 孩子 。 
she cooked herself a good meal . 	她 为 自己 煮 了 好吃 的 一餐 。 
a burglar broke into his house . 	一个 窃贼 闯进 了 他 的 房子 。 
these are called shoes . 	这些 叫 鞋子 。 
you seem to be waiting for somebody . 	你 看来 在 等 人 。 
the weather is usually hot in july . 	七月 天气 经常 很 热 。 
that 's an exception . 	那 是 例外 。 
what do you call this bird ? 	这 只 鸟 叫作 什么 ? 
tom is a good friend of mary 's . 	汤姆 是 玛丽 的 一个 好 朋友 。 
it 's been raining since last night . 	从 昨晚 起 一直 下雨 。 
i feel hope@@ ful about the future . 	我 对 未来 感到 有 希望 。 
i only spent three dollars . 	我 只花 了 三 美元 。 
hurry up , or you will miss the train . 	快点 ， 不然 你 就要 错过 火车 了 。 
it does n't matter what you do . 	你 做 什么 都 无所谓 。 
we watched the soccer game on tv . 	我们 看 了 电视 上 的 足球 比赛 。 
my brother is holding a camera in his hand . 	我 弟弟 手里 拿 着 一个 摄像机 。 
the little cab@@ in was bath@@ ed in moonlight . 	小 木屋 沐浴 在 月光 之中 。 
you 're such a j@@ erk . 	你 真是 个 傻子 。 
`` will you have some more coffee ? '' `` no , thanks . i 've had enough . '' 	“ 你 想 再 来 点 咖啡 吗 ？ ” “ 不 ， 谢谢 。 我够 了 。 ” 
what is your mother tongue ? 	你 的 母语 是 什么 ？ 
i guess that 's how tom found me . 	我 猜 那 就是 汤姆 找到 我 的 方法 。 
he will succeed to the throne . 	他会 继承 王位 。 
i feel very sorry for your sister . 	我 对 你 姐姐 感到 非常 遗憾 。 
i intend to go there . 	我 打算 去 那里 。 
how long does it take to get to the station ? 	去 火车站 要 多久 ？ 
it does n't make sense to me . 	这 对于 我 来说 没 任何 意义 。 
it 's really bad for your eyes . 	它 对 你 的 眼睛 有害 。 
divide the pizza in three . 	把 披萨 分成 三份 。 
have you ever seen a u@@ f@@ o ? 	你 看过 飞碟 吗 ？ 
there is a large supermarket . 	有 一个 大型 超市 。 
i have a lot of friends to help me . 	我 有 很多 朋友 帮 我 。 
the economy is pic@@ king up . 	经济 在 复苏 之中 。 
waiter , please bring me some water . 	服务生 ， 请 给 我 一些 水 。 
his son wants to be a lawyer . 	他 儿子 想当 律师 。 
tom was sick in bed last sunday . 	汤姆 上周日 卧病 在 床 。 
you must make up for the loss . 	您 必须 弥补 损失 。 
the taxi i took was very old and small . 	我 打 的 这辆 出租车 很 老 ， 也 很小 。 
tom 's comment was in@@ appro@@ priate . 	汤姆 的 评论 不 合适 。 
the moon was full last night . 	昨晚 月亮 满 了 。 
they were afraid . 	他们 害怕 了 。 
it 's likely to snow this evening . 	今天 晚上 可能 会 下雪 。 
we happened to get on the same bus . 	我们 恰巧 上 了 同 一辆 公交车 。 
nothing is going his way . 	什么 都 没 按 他 的 路子 走 。 
she gave us lots to eat . 	她 给 了 我们 很多 吃 的 东西 。 
do you really believe in ghosts ? 	你 真的 相信 鬼 吗 ？ 
i wish i had n't bought this . 	我 希望 我 没 买 这 东西 。 
tom is in danger . 	汤姆 有 危险 。 
tom was too afraid to do anything . 	Tom 太 胆小 了 以至于 做不了 任何 事 
i did n't call on him because i had a cold . 	我 没有 拜访 他 ， 因为 我 感冒 了 。 
tom has n't talked to mary in years . 	汤姆 多年 没有 和 玛丽 说话 了 。 
let 's turn back . 	我们 掉头 吧 ！ 
kyoto is famous for its old tem@@ pl@@ es . 	京都 以 古庙 有名 。 
you 're probably smar@@ ter than you think . 	你 可能 比 你 想 的 更 聪明 。 
he 's going to have a heart attack . 	他 的 心脏病 要 发作 了 。 
tom is our oldest son . 	汤姆 是 我们 最大 的 儿子 。 
it happened at a quarter past eleven . 	它 发生 在 十一点 一刻 。 
he probably wo n't come . 	他 可能 不会 来 了 。 
i suggest that you do n't trust tom too much . 	我 建议 你别 太 相信 汤姆 。 
she was run over by a car . 	她 被 车子 辗过 了 。 
please contact us . 	请 联系 我们 。 
what did you do yesterday evening ? 	你 昨天 晚上 做 了 什么 ？ 
to the man who only has a hammer in the tool@@ k@@ it , every problem looks like a na@@ il . 	对 工具 箱里 只有 一把 榔头 的 人 来说 ， 所有 的 问题 都 像 钉子 。 
in the morning , i write in the park . 	我 每天 早上 在 公园 写作 。 
he hid his friend from the police . 	他 把 他 的 朋友 藏 了 起来 不让 警察 知道 。 
i need to sear@@ ch for my pen . 	我 得 查找 一下 我 的 笔 。 
not every country belongs to the u@@ .@@ n . 	不是 所有 国家 都 加入 了 联合国 。 
i competed with him for the cha@@ mpi@@ on@@ ship . 	我 和 他 竞争 冠军 。 
please put on these sli@@ pp@@ ers . 	请 穿 上 这些 拖鞋 。 
she asked how to cook the fish . 	她 问 了 怎么 烧鱼 。 
i have been to rome . 	我 去过 罗马 。 
i bought a dozen penci@@ ls today . 	我 今天 买 了 一打 铅笔 。 
i do n't want to go to school . 	我 不想 去 学校 。 
tom is extremely romantic . 	汤姆 非常 的 浪漫 。 
where can i take a bath ? 	我能 在 哪里 洗澡 ？ 
the moon is the earth 's only sa@@ telli@@ te . 	月球 是 地球 唯一 的 卫星 。 
i ca n't believe tom is really planning to do this . 	我 无法 相信 汤姆 真的 打算 做 这 事儿 。 
is there anything i must do ? 	有 什么 事是 我 该 做 的 吗 ？ 
it was a bag that i lost in the room yesterday . 	它 是 我 昨天 遗失 在 房里 的 包 。 
does anyone want some more pie ? 	有人 想要 更 多 的 馅饼 吗 ？ 
everything seems ok . 	一切 看上去 正常 。 
keep working . 	继续 工作 ！ 
do n't be sad . 	别 伤心 。 
i have to go to sleep . 	我 该 去 睡觉 了 。 
you are the master of your own de@@ stin@@ y . 	你 才 是 自己 命运 的 主人 。 
mer@@ ry christmas ! 	圣诞 快乐 。 
i admit that i was a little drunk . 	我 承认 当时 是 有点 醉 。 
can you put me up tonight ? 	今晚 可以 住 你家 吗 ？ 
she is looking for her missing wallet . 	她 正在 找 她 不见 了 的 皮夹 。 
i do n't like the way he speaks . 	我 不 喜欢 他 说 的话 。 
he used to read at night . 	他 以前 都 在 夜晚 看书 。 
that river is dangerous . 	那条 河是 危险 的 。 
he was sitting there . 	他 之前 坐在 这里 。 
i followed the de@@ er 's tra@@ cks . 	我 跟着 鹿 的 踪迹 。 
somebody came . 	有人 来 了 。 
why did we fail ? 	我们 为 甚么 失败 了 ？ 
no matter what happens , i 'm not changing my mind . 	无论如何 ， 我 不会 改变 我 的 想法 。 
he has never played golf . 	他 从没 打过 高尔夫球 。 
how long will this rain go on ? 	雨会 下 多久 ？ 
i just ca n't believe it . 	我 真是 不能 相信 。 
i read a book last night . 	我 昨晚 读书 。 
when i arrived , it was raining . 	当 我 到达 时 ， 天正 下著雨 。 
he 's new in town . 	他 刚来 这 镇上 。 
i 'd like seats on the first floor . 	我 想要 一楼 的 座位 。 
when do you practice the piano ? 	你 什么 时候 练习 弹 钢琴 ？ 
did tom use to be a teacher ? 	汤姆 以前 是 教师 吗 ？ 
if you ca n't come , you should let me know ahead of time . 	如果 你 不能 来 ， 你 该 让 我 提前 知道 。 
i wo n't be home next sunday . 	我下 周日 不 在家 。 
my uncle made me serve as interpreter . 	我 舅舅 让 我 担任 翻译 。 
when does it arrive ? 	它 什么 时候 到 ？ 
she was born in america . 	她 生 在 美洲 。 
you look just like tom . 	你 看起来 就 像 汤姆 。 
all the world speaks english . 	世界各地 都 说 英语 。 
she left her son a lot of money . 	她 留 了 很多 钱 给 她 儿子 。 
a cafeteria is a self-@@ service style restaurant . 	自助 餐厅 是 一种 自助 式 的 餐厅 。 
drive carefully . 	开车 小心 点 。 
why are you still un@@ married ? 	你 为 甚么 还 不 结婚 ？ 
are you going to attend the meeting ? 	你 要 参加 会议 吗 ？ 
we have some deci@@ sions to make . 	我们 要 做些 决定 。 
he likes to listen to the radio . 	他 喜欢 听 收音机 。 
i love watching talk sho@@ ws . 	我 爱看 脱口秀 。 
i used to play tennis . 	我 以前 打 网球 。 
summer is over . 	夏天 过去 了 。 
how tall are your parents ? 	你 的 父母 有 多 高 ？ 
a wise man pro@@ fits from his mistakes . 	聪明人 会 从 自己 的 错误 中 受益 。 
what exactly does tom do ? 	汤姆 究竟 在 做 什么 ？ 
he kept his promise . 	他 信守 了 他 的 承诺 。 
i got tired with the work . 	我 对 这份 工作 感到 疲乏 了 。 
have you ever seen him swimming ? 	你 曾 看过 他 游泳 吗 ？ 
we must ob@@ serve the rules . 	我们 必须 遵守 规则 。 
i will never forget your kindness . 	我 永远 不会 忘记 你 的 亲切 。 
no matter what i do , she says i can do better . 	不论 我 做 什么 ， 她 都 说 我 能 做 得 更好 。 
she dis@@ liked her husband . 	她 不 喜欢 她 的 丈夫 。 
tom is playing the violin now . 	汤姆 正在 拉 小提琴 。 
let 's leave the decision to tom . 	让 我们 留给 他作 决定 。 
we 've got lots of time . 	我们 有 很多 时间 。 
why do you think that i 'm thinking about you ? 	你 为什么 会 认为 我 在 想 你 ？ 
she gave me a watch . 	她 给 了 我 一支 手表 。 
stars began to appear in the sky . 	星星 开始 在 天空 中 出现 。 
it stopped snowing an hour ago . 	一个 小时 前雪停 了 。 
their wedding will be tomorrow . 	他们 的 婚礼 将 在 明天 举行 。 
do you have a map ? 	你 有 地图 吗 ？ 
to my knowledge , she has n't married yet . 	据 我 所知 ， 她 还 没 结婚 。 
yes , i have a good idea . 	是 的 ， 我 有 一个 好 主意 。 
a card was atta@@ ched to the gift . 	一张 卡片 被 附 在 了 礼物 上 。 
where do you watch television ? 	您 在 哪儿 看电视 ？ 
he was scared you would shoot him . 	他 害怕 你 会 开枪 打 他 。 
i 'm 1@@ 7 , too . 	我 也 是 17 岁 。 
volleyball is a lot of fun . 	排球 很 有意思 。 
study hard . 	好好 学习 。 
i 'm good at soccer . 	我 擅长 足球 。 
i 'm afraid the job i 've got for you wo n't be easy . 	我 恐怕 我 给 你 找 的 工作 不 轻松 。 
i ran away in a hurry . 	我 赶快 跑 走 了 。 
kar@@ u@@ iz@@ aw@@ a is famous as a summer res@@ ort . 	轻井泽是 著名 的 避暑 胜地 。 
they were all ho@@ ar@@ se from shouting . 	他们 全都 叫 到 沙哑 了 。 
i 'm sorry , could you say that again ? 	抱歉 ， 你 能 再说 一遍 吗 ？ 
you 've made a mistake . 	你 犯 了 个 错误 。 
can you tell wh@@ eat from bar@@ le@@ y ? 	你 能 辨别 小麦 和 大麦 吗 ？ 
you seem very nervous . 	你 看起来 很 紧张 。 
her older daughter is married . 	她 的 大 女儿 结婚 了 。 
the students have returned . 	学生 们 回来 了 。 
my business has at last gotten on the right track . 	我 的 生意 终于 上 了 轨道 。 
my uncle lives near the school . 	我 叔叔 住 在 学校 附近 。 
how could i be a robo@@ t ? robo@@ ts ca n't dream . 	我 怎么 可能 是 机器人 呢 ？ 机器人 不会 做梦 。 
kyoto has many places to see . 	在 京都 ， 有 很多 的 景点 值得 一看 。 
in life there are u@@ ps and dow@@ ns . 	生活 中有 高低 起伏 。 
i 'm the one who has to do this . 	我 是 必须 去 做 这事 的 人 。 
please drive carefully . 	请 小心 驾驶 。 
what do you think of japan 's economy ? 	您 怎样 看 日本 的 经济 呢 ？ 
you do n't deserve it . 	你 不配 。 
she was not a very good pianist . 	她 不是 一个 很 好 的 钢琴家 。 
it 's been ten years since we last met . 	我们 离 上次 见面 有 十年 了 。 
just put those pack@@ ages anywhere . 	只要 把 那些 包包 放在 任何 地方 都行 。 
stick another stamp on the envelope . 	把 另 一张 邮票 贴 在 信封 上 。 
the volcan@@ o has become active again . 	这座 火山 又 开始 活动 了 。 
i 'd like to send this package to japan . 	我 想 把 这个 包裹 寄到 日本 。 
he was kind enough to lend me some money . 	他够 大方 ， 借 了 我 一点 钱 。 
our baby can not talk yet . 	我家 宝宝 还 不会 说话 。 
come in , it 's open . 	进来 ， 门开 着 。 
i wish we had won the game . 	要是 我们 赢 了 这场 比赛 就 好 了 。 
tom studied hard so he could get into college . 	汤姆 努力 学习 以 进入 大学 。 
help yourself to whatever you like . 	随 你 喜欢 随便 吃 。 
they went to the station by car . 	他们 坐车 去 车站 。 
i wrote down the address for you . 	我 给 你 写下 了 地址 。 
she told him that she believed in a@@ stro@@ logy . 	她 告诉 了 他 自己 相信 占星术 。 
do n't forget to turn the light off . 	不要 忘 了 关灯 。 
he made his way to the room . 	他 走进 了 房间 。 
she is n't a good cook . 	她 不是 一个 好 厨师 。 
he is to blame for the failure . 	失败 的 责任 在 他 。 
is it true that tom wants to paint his house green ? 	汤姆 想 把 房子 漆成 绿色 ， 是 真的 吗 ？ 
whichever rou@@ te you take , you will get there in time . 	不管 你 选 哪 条路 ， 你 都 能 按时 到 那里 。 
if you eat that much , you 'll have a stomachache . 	那么 吃 的话 ， 肚子 会 吃 坏 的 噢 。 
the tiger cu@@ b looked like a large ki@@ tten . 	小 老虎 看起来 像 只 大猫 。 
he gave me 10,000 yen . 	他 给 了 我 1 万日元 。 
tom does n't have a fever . 	汤姆 没有 发烧 。 
i will finish my homework by nine . 	我会 在 九点 前 完成 我 的 作业 。 
two people can enter with this ticket . 	两个 人 可以 用 这 张票 入场 。 
i do n't agree with you . 	我 不 同意 你 的 看法 。 
i should be happy . 	我该 高兴 。 
whose cup is this ? 	这 是 谁 的 杯子 ？ 
the boys kept quiet . 	男孩子 们 保持 安静 。 
let 's finish up in a hurry . 	让 我们 快点 做 完 吧 。 
please lock the door . 	请 把 门锁 上 。 
nobody supp@@ or@@ ted her . 	没人 支持 她 。 
your problem is similar to mine . 	你 的 问题 类似 于 我 的 。 
he did not work on sunday night . 	他 周日 晚上 不 工作 。 
there is n't anyone in the room . 	房间 里 没有 任何人 。 
news of the recent b@@ last is all over the radio . 	收音机 广播 充斥 著 有关 最近 爆炸 的 新闻 。 
he introduced me to his parents . 	他 把 我 介绍 给 他 的 父母 认识 。 
for qu@@ anti@@ ties of 20 or more , we can allow you a special discount of 10 % on the prices quo@@ ted . 	20 个 以上 九折 特惠 。 
her mother is writing a letter . 	她 的 母亲 正在 写信 。 
i forgot to bring my i@@ .@@ d . card . 	我 忘 了 带 我 的 身份证 。 
we do n't have class on wednesday after@@ no@@ ons . 	我们 周三 下午 没课 。 
i do n't understand music . 	我 不 懂 音乐 。 
he loves her . she loves him , too . 	他 爱 她 。 她 也 爱 他 。 
we are traveling on a tight bu@@ dget . 	我们 很 节省 地 旅行 。 
what 's the name of this tune ? 	这歌 叫 什么 名字 ？ 
he likes watching tv . 	他 喜欢 看电视 。 
do you deny that you went there ? 	你 否认 你 去 了 那里 吗 ? 
tom told mary something she did n't want to hear . 	汤姆 告诉 了 玛丽 她 不想 知道 的 事 。 
every one of his songs was a hit . 	他 的 每 首歌 都 长期 备受 欢迎 。 
`` i feel like playing cards . '' `` so do i . '' 	“ 我 想 打牌 。 ” “ 我 也 是 。 ” 
this clock is n't working . 	这表 不 走 了 。 
have you read this book yet ? 	你 读过 这 本书 吗 ？ 
i agree with that . 	我 同意 。 
when do you need it by ? 	您 何时 需要 它 ？ 
you should apologize for your rudeness . 	您 该 为 您 的 粗鲁 道歉 。 
the boy is wearing glasses . 	这个 男孩 戴著 眼镜 。 
she wants to know who sent the flowers . 	她 想 知道 是 谁 送 的 花 。 
take whatever you like . 	你 喜欢 什么 就 拿 吧 。 
sit wherever you like . 	你 爱 坐 哪里 就 坐 哪里 。 
all partici@@ pants must be registered . 	所有 的 参加者 都 得 注册 。 
may i ask some questions ? 	我 可以 问 一些 问题 吗 ? 
i wish to see my father . 	我 希望 看看 我 的 父亲 。 
some ab@@ stract art is difficult to understand . 	一些 抽象 艺术 是 很 难 理解 的 。 
there are many ships in the harbor . 	港口 内有 许多 船 。 
i can do it by myself . 	我 可以 自己 做 。 
he changed schools last year . 	去年 他 转校 了 。 
she went to the museum by taxi . 	她 搭 计程车 去 博物馆 了 。 
may i share this table with you ? 	我 可以 跟 你 共用 这张 桌子 吗 ? 
the sur@@ r@@ oun@@ ding area was very quiet . 	周围 的 地区 非常 安静 。 
you ca n't fight a good fight with such a de@@ fea@@ ti@@ st attitude . 	抱著 失败 主义 的 态度 你 无法 打 一场 漂亮 的 仗 。 
it is close to eleven . it 's about time we went to bed . 	快 11 点 了 。 我们 该 上床 睡觉 了 。 
he was almost hit by a car . 	他 差点 被 一辆 汽车 撞 上 了 。 
the two men were business part@@ ners . 	这 两个 男人 是 生意 上 的 合作 伙伴 。 
i must 've mi@@ sty@@ ped the number . 	我 一定 是 打错 号码 了 。 
the ha@@ w@@ k caught a mou@@ se . 	这 只鹰 抓 到 一只 老鼠 。 
he owes his success both to working hard and to good luck . 	他 的 成功 要 归结 于 他 的 辛勤 工作 和 好 运气 。 
christmas is coming . 	圣诞节 快到 了 。 
i 'll send a letter to my mother . 	我会 给 我 的 母亲 寄 封信 。 
he will not listen to me . 	他 不会 听 我 的 。 
we have to turn in our reports by the end of this month . 	这个 月底 前 ， 我们 必须 交 报告 。 
tom runs faster than me . 	汤姆 跑 得 比 我 快 。 
you should consult your doctor . 	你 应该 咨询 你 的 医生 。 
salt helps to pre@@ serve food from de@@ c@@ ay . 	盐 可以 帮助 保存 食物 避免 腐烂 。 
i 'm leaving for canada tomorrow . 	我 明天 要 离开 去 加拿大 。 
may i speak to you a minute ? 	我 可以 和 你 讲 一下 话 吗 ? 
you owe me an apology for that . 	关于 那件 事 你 欠 我 一个 道歉 。 
i got this cd player for free . 	我 免费 得到 这个 CD 播放机 。 
be quiet , or the baby will wake up . 	安静 ， 否则 婴儿 会 醒来 。 
one hundred years is called a century . 	一百年 称为 一个 世纪 。 
du@@ tch is close@@ ly related to german . 	荷兰语 与 德语 关系 密切 。 
you did n't tell me mary was so beautiful . 	你 没 告诉 我 玛丽 这么 漂亮 。 
i wonder why he did that . 	我 不 知道 他 为什么 那样 做 ？ 
it was difficult for him to hide his pride in his success . 	他 很 难 掩饰 对 自己 成功 的 骄傲 。 
would you like some more tea ? 	您 想 再 来 点 茶 吗 ？ 
what 's going on with tom ? 	汤姆 出 什么 事 了 ？ 
he told me to do it , so i did it . 	他 让 我 做 ， 我 就 做 了 。 
she was busy with her kni@@ tting . 	她 忙 着 编织 。 
it 's my treat . 	我 请客 。 
you should take the number 5 bus . 	您 应该 乘 5 路车 。 
his book is very interesting . 	他 的 书 非常 有趣 。 
the things he says are enti@@ rely in@@ con@@ se@@ qu@@ enti@@ al . 	他 说 的话 根本 毫无 意义 。 
please bring us two cups of coffee . 	请 给 我们 来 两杯 咖啡 。 
mom , can i go swimming ? 	妈妈 ， 我能 去 游泳 吗 ？ 
i really like him , but not his circle of friends . 	我 真的 很 喜欢 他 , 可是 我 不 喜欢 他 周围 的 朋友 。 
my uncle comes to see me from time to time . 	我 叔叔 偶尔 来看 我 。 
i think i understood . 	我 认为 我 明白 了 。 
tom will never wi@@ ll@@ ing@@ ly go there by himself . 	汤姆 绝不 会 愿意 独自 去 那里 。 
it 's already past ten o'clock . 	已经 过 了 十点 钟 了 。 
she is at work right now . 	她 现在 正在 工作 。 
wash your face and hands . 	洗 你 的 脸 和 手 。 
i 've already put tom to work on it . 	我 已经 让 汤姆 去 做 它 了 。 
i do n't like this jacket . 	我 不 喜欢 那件 夹克 。 
how long did you stay ? 	你 待 了 多久 ? 
your family 's waiting for you . 	你 的 家人 在 等 你 。 
she gave me a smile of recogni@@ tion . 	她 给 了 我 一个 认可 的 微笑 。 
let 's meet in front of the theater . 	让 我们 在 戏院 前面 碰面 。 
it was very kind of you to lend me an umbrella . 	你 借给 我 伞 真 好 。 
i found the bed quite comfortable . 	我 觉得 这 张床 相当 地 舒适 。 
is it really that hard to speak french ? 	说 法语 真有 那么 难 吗 ？ 
strike while the iron is hot . 	打铁 趁热 。 
his son was ex@@ p@@ el@@ led from school . 	他 的 儿子 被 学校 开除 了 。 
where does your uncle live ? 	你 叔叔 住 在 什么 地方 ？ 
she made the same mistake again . 	她 又 犯 了 同样 的 错误 了 。 
we 're both reasonable people . 	我们 是 两个 通情达理 的 人 。 
her father passed away last week . 	她 的 父亲 上周 去世 了 。 
we discussed the plan yesterday . 	昨天 我们 讨论 了 这个 计划 。 
his name is not on the list . 	他 的 名字 不 在 名单 里 。 
when did you learn to swim ? 	你 什么 时候 学会 游泳 的 ？ 
i 'm hungry , so i 'm going to get something to eat . 	我 饿 了 ， 所以 我要 吃 东西 。 
she kept on working . 	她 继续 工作 。 
you should have done it earlier . it can not be helped now . 	你 应该 早点 做 的 。 现在 没人 可以 帮 你 。 
a gentleman would n't do such a thing . 	一个 绅士 是 不会 做 这种 事 的 。 
get out of here . 	离开 这里 。 
english is studied all over the world . 	世界各地 都 读 英语 。 
i guess that would be all right . 	我 想 那 应该 没关系 的 。 
i have an umbrella in my car . 	我 的 车里 有 伞 。 
could i see you in private ? 	我能 私下 见 你 吗 ？ 
i was very busy last week . 	上星期 我 非常 地忙 。 
would you care for more coffee ? 	你 想 再 喝点 咖啡 吗 ？ 
i 'm in a hurry today . 	我 今天 赶 时间 。 
who died ? 	谁 死 了 ？ 
she can swim as fast as her brother . 	她 能 和 她 哥哥 游得 一样 快 。 
they are very big apples . 	他们 是 非常 大 的 苹果 。 
we had some chicken soup . 	我们 喝 了 些 鸡汤 。 
i asked her out on a date . 	我 请 她 出去 约会 。 
choose the one you like . 	选 喜欢 的 。 
his quick temper will get him in trouble one day . 	他 的 急 脾气 迟早 会 惹祸 上身 。 
we need tom back . 	我们 需要 汤姆 回来 。 
i expect her back by six o'clock . 	我 希望 她 六点 前 回来 。 
hurry up ! we 'll be late . 	快点 ！ 我们 要 迟到 了 。 
if tom is really alive , where is he ? 	如果 汤姆 真的 活着 ， 他 在 哪里 ？ 
there are 50 members in the club . 	这个 俱乐部 有 50 位 成员 。 
you hate tom , do n't you ? 	你 恨 汤姆 ， 不是 么 ？ 
it happened a long time ago . 	这事 发生 在 很多年 以前 。 
you 'll get lost . 	你 会 迷路 的 。 
see you tonight . 	今晚 见 。 
tom complained that mary never helped him . 	汤姆 埋怨 玛丽 从来不 帮 他 。 
take off your hat when you enter a classroom . 	进 教室 时请 脱下 帽子 。 
you must pay attention to him . 	你 必须 注意 他 。 
tom is a rab@@ b@@ i . 	汤姆 是 个 拉比 。 
i 'm just a plain old office worker . 	我 只是 一个 普通 的 老式 上班族 。 
she tried to lift the box , but found it impossible to do . 	她 试著 举起 箱子 ， 但 发现 不 可能 做到 。 
who is going to speak tonight ? 	今晚 谁 发言 ？ 
time for dinner . 	吃饭 时间 到 了 。 
do you regret mar@@ rying me ? 	你 后悔 跟 我 结婚 吗 ? 
it is still fresh in my memory . 	我 仍然 记忆犹新 。 
rab@@ bits have long ears and short ta@@ ils . 	兔子 长着 长长的 耳朵 和 短短的 尾巴 。 
she we@@ pt the entire night . 	她 一整 晚 都 在 哭 。 
we 're the same age . 	他 和 我 同岁 。 
i got on the wrong bus . 	我 上 错车 了 。 
that wo n't change anything . 	这样 做 的话 什么 都 不会 改变 的 。 
i heard someone calling my name . 	我 听见 有人 叫 我 的 名字 。 
all their efforts were in va@@ in . 	他们 的 努力 都 白费 了 。 
which season do you like the best ? 	您 最 喜欢 哪个 季节 ？ 
maybe tom just got nervous . 	可能 汤姆 紧张 了 。 
that 's all i could find . 	那 是 我 所有 能 找到 的 。 
this box is too bul@@ k@@ y to carry . 	这个 箱子 太 笨重 了 无法 携带 。 
be@@ e@@ tho@@ ven was a great musi@@ cian . 	贝多芬 是 一个 伟大 的 音乐家 。 
how long will we have to wait ? 	我们 要 等 多久 ？ 
he crossed the river in a small boat . 	他 乘 小船 过河 。 
the law should not be vio@@ lated . 	法律 不应 受到 侵犯 。 
i ca n't find my glasses . 	我 找 不到 我 的 眼镜 。 
hurry , and you will catch the train . 	快 一点 ， 你 就 能 赶上 火车 了 。 
what are you going to do today ? 	你 今天 要 做 什么 ? 
is the post office still closed ? 	邮局 还关 着 门 吗 ？ 
i 'm sorry for the late respon@@ se . 	我 很 抱歉 回复 晚 了 。 
do n't put your elbo@@ ws on the table . 	不要 把 你 的 手肘 放在 桌子 上 。 
this ta@@ pe recor@@ der is not new . 	这个 磁带 录音机 不是 新 的 。 
does tom live in boston ? 	汤姆 住 在 波士顿 吗 ？ 
my whole body hurts . 	我 全身 酸痛 。 
my father is far from arti@@ stic . 	我 父亲 一点 也 不 懂 艺术 。 
it might rain . 	可能 要 下雨 了 。 
what happened here ? 	这儿 发生 了 什么 事 ？ 
she is everything to him . 	她 是 他 的 一切 。 
tom says he did n't know what to do . 	汤姆 说 他 不 知道 要 做 什么 。 
they tied the thief to the tree . 	他们 把 小偷 绑 到 了 树上 。 
put your hands up ! 	把手 举 起来 ！ 
i like movies a lot . 	我 很 喜欢 电影 。 
does the letter need to be written in english ? 	这 封信 需要 用 英文 写 吗 ？ 
i must go home . 	我该 回家 了 。 
we do what we want to do . 	我们 做 我们 想 做 的 。 
how complex is it ? 	它 有 多 复杂 ？ 
the car@@ pen@@ ter brought his tool@@ s along . 	木匠 带著 他 的 工具 。 
who car@@ es ? 	爱 谁 谁 。 
how many cds do you have ? 	你 有 多少 张 CD ？ 
tom did n't accept mary 's apology . 	汤姆 不 接受 玛丽 的 道歉 。 
do you have tom 's address ? 	你 有 汤姆 的 住址 吗 ？ 
i 'm as hungry as a horse . 	我 饿 得 跟 饿 虎 扑 羊 似的 。 
that goes without saying . 	不言而喻 。 
you ought to get to work on time . 	你 应该 准时 上班 。 
i bought this yesterday . 	昨天 我 买 了 这个 。 
if you do not have this program , you can down@@ loa@@ d it now . 	假如 你 没有 这个 程序 ， 你 现在 就 可以 去 下载 。 
an old man was resting in the sha@@ de of the tree . 	一个 老人 在 树荫 下 休息 。 
nothing is as pre@@ cious as love . 	没有 什么 东西 是 跟 爱 一样 珍贵 的 。 
tom is taller than his mother . 	汤姆 比 他 的 母亲 高 。 
do you think tom will show up ? 	你 认为 汤姆 会 出现 吗 ？ 
this is going to be a great trip . 	这会 是 个 绝好 的 旅行 。 
did she show you the picture ? 	她 给 你 看过 照片 了 吗 ? 
the soldier gave water to me . 	士兵 给 了 我 水 。 
i 'll be in my office from ten tomorrow . 	我 明天 十点 起会 在 办公室 里 。 
it wo n't take much time . 	不会 花 很多 时间 的 。 
there is a for@@ k missing . 	少 一把 叉子 。 
mary is going to help us tomorrow . 	玛丽 明天 会来 帮 我们 。 
they guaran@@ te@@ ed regular employ@@ ment to their workers . 	他们 对 他们 的 员工 保证 就业 。 
the thief got in without being noticed . 	小偷 在 没有 被 发现 的 情况 下 进去 了 。 
my father is in the garden . 	我 爸爸 在 花园里 。 
i want to go and change into that shirt i bought yesterday . 	我 想 去 换 我 昨天 买 的 这件 衬衫 。 
my watch is five minutes slow . 	我 的 表慢 了 五分钟 。 
i have no excuse . 	我 没有 借口 。 
the buildings shook in the earthquake . 	建筑物 在 地震 中 摇晃 。 
do you know how far it is from the station to city hall ? 	你 知道 从 火车站 到 市政府 有多远 ？ 
thank you for the pleasant evening . 	谢谢 你 让 我 度过 一个 愉快 的 晚上 。 
the blanket is still wet . 	这个 毯子 还是 湿 的 。 
money can not buy happiness . 	钱 买 不到 幸福 。 
he 's shorter than tom . 	他 比 汤姆 矮 。 
have you ever written a blo@@ g ? 	你 写 过 博客 吗 ？ 
the doctor told her that she should take a rest . 	医生 告诉 她 要 静养 。 
i 'm sure tom wo n't have any trouble finding us . 	我 确定 汤姆 找到 我们 没有 任何 问题 。 
he does n't know how to play golf . 	他 不 知道 如何 打 高尔夫球 。 
tom made a choice . 	汤姆 做出 了 选择 。 
someone yel@@ led for help . 	有人 呼救 。 
she thought that i was a doctor . 	她 以为 我 是 大夫 。 
you 're old enough to know better . 	你 年龄 足够 大 了 ， 该 了解 更 多 。 
i do n't know for certain . 	我 不 太 确定 。 
i 'm just a regular office worker . 	我 只是 一个 普通 的 上班族 。 
a sti@@ tch in time sa@@ ves nine . 	防微杜渐 。 
i found what i was looking for . 	我 找到 了 我 正在 找 的 东西 。 
i always rely on him in times of trouble . 	我 在 困难 时 总是 依赖 他 。 
you should pay your rent in advance . 	你 应该 提前 付 租金 。 
our team won the game . 	我们 这队 赢得 了 比赛 。 
tom and i know each other quite well . 	汤姆 和 我 互相 很 了解 。 
i 'm accustomed to getting up early . 	我 习惯 早起 。 
tom and mary could n't help me do that . 	汤姆 和 玛丽 不能 帮 我 去 做 。 
i am sick . 	我 生病 了 。 
my mother made me a christmas cake . 	母亲 做 了 一个 圣诞 蛋糕 给 我 。 
a per@@ si@@ an cat was sleeping under the table . 	波斯猫 在 桌子 下面 睡觉 。 
he often sits by me and list@@ ens to music . 	他 经常 坐在 我 旁边 听 音乐 。 
i found it by chance . 	我 偶然 找到 了 它 。 
go straight down this street and turn right at the third light . 	沿着 这条 路直 走 ， 到 第三个 红绿灯 的 地方 右转 。 
that white dress looks good on you . 	你 穿 那件 白色 的 衣服 很 好看 。 
i do n't care as long as you are happy . 	只要 你 开心 就行 了 。 
i was surprised at his strong resemb@@ lance to his father . 	他 像 极了 他 父亲 ， 这 让 我 震惊 。 
i think you 're stupid . 	我 认为 你 傻 。 
this house belongs to my uncle . 	这栋 房子 属于 我 的 叔叔 。 
i am happy to see you here . 	我 很 高兴 在 这里 看到 你 。 
they settled in canada . 	他们 在 加拿大 安家落户 。 
i arrived two weeks ago . 	我 在 两周 前到 了 。 
tom is shy . 	汤姆 害羞 。 
i 'm tired of your compla@@ ints . 	我 已经 厌倦 了 你 的 投诉 。 
some things are better left undone . 	有些 事 不 做 更好 。 
i 'd like a room in the front . 	我 想要 一间 前面 的 房间 。 
tom needs the money right away . 	汤姆 现在 就 需要 钱 。 
i think he 's a great writer . 	我 认为 他 是 位 伟大 的 作家 。 
where is m@@ ani@@ l@@ a ? 	马尼拉 在 哪里 ？ 
this book is beauti@@ fully illu@@ strated . 	这 本书 有 精美 的 插图 。 
i still love him . 	我 依旧 爱着 他 。 
she got in at 9 p@@ .m . 	她 晚上 九点 钟上 了 车 。 
i found a co@@ in on the si@@ de@@ walk . 	我 在 人行道 上 发现 了 一枚 硬币 。 
he knows better than to marry her . 	他 不会 傻到 去 娶 她 。 
my father began jogging last month . 	我 父亲 上个月 开始 慢跑 。 
is it yours ? 	这 是 你 的 吗 ？ 
are these your things ? 	这些 是 你 的 东西 吗 ？ 
we all wondered why she had du@@ mped such a nice man . 	我们 都 想 知道 她 为什么 甩 了 这么 好 的 一个 男人 。 
where in australia did you grow up ? 	你 在 澳洲 的 哪里 长大 ? 
tom is in the hospital . 	Tom 在 医院 。 
the girl was gaz@@ ing at the doll . 	女孩 凝视 着 洋娃娃 。 
what 's your name ? 	叫 什么 名字 ? 
where is the police station ? 	警察局 在 哪里 ？ 
the contract is in the bag , so let 's go out and cele@@ bra@@ te . 	合同 已经 到手 了 ， 那 就 出去 庆祝 一下 吧 。 
why do n't we have dinner ? 	为 甚么 我们 不吃 晚饭 ？ 
she made cookies for the children . 	她 为 孩子 们 做 了 饼干 。 
can his story be true ? 	他 的 故事 可能 是 真的 吗 ? 
i 've climbed mt . fuji twice . 	我 爬 过 两次 富士山 。 
tom lied . 	汤姆 说谎 了 。 
he does n't al@@ together trust me . 	他 并 不 完全 信任 我 。 
he had his sister help him paint the wall of his room . 	他 让 妹妹 帮 他 涂 他 房间 的 墙 。 
i was already tired . 	我 已经 累 了 。 
he walked past the house . 	他 走过 这栋 房子 。 
she is interested in learning new ideas . 	她 有 兴趣 学习 新 的 想法 。 
i wonder if he loves me . 	我 不 知道 他 是否 爱 我 。 
i know how to set a trap . 	我 知道 怎么 设 陷阱 。 
what did you buy ? 	你 买 了 什么 ？ 
we bought some vegetables and fish at the market . 	我们 在 市场 上 买 了 些 蔬菜 和 鱼 。 
tex@@ ting while driving is dangerous . 	开车 时 打字 是 危险 的 。 
she to@@ ssed me grapes and i tried to catch them with my mouth . 	她 朝 我 丢 葡萄 ， 我试 着 用 嘴 接住 它们 。 
can i use your pencil ? 	我 可以 用 你 的 铅笔 吗 ？ 
i have a stupid question . 	我 有 一个 愚蠢 的 问题 。 
it 's not my fault . 	不是 我 的 错 。 
that was n't my intention . 	那 不是 我 的 本意 。 
on the whole , the event was successful . 	整体而言 ， 这个 事件 是 成功 的 。 
i like sports . 	我 喜欢 运动 。 
the pre@@ cise time of their arri@@ val is not known . 	他们 到 逹 的 确切 时间 还 不 知道 。 
i 'm glad you were right . 	很 高兴 你 是 对 的 。 
japan is an extremely noisy country . 	日本 是 一个 非常 嘈杂 的 国家 。 
you need a large vo@@ ca@@ bul@@ ary to read that book . 	你 读 那 本书 需要 大量 词汇 。 
she 's sitting on the bench . 	她 坐在 长椅 上 。 
it is none of your business . 	跟 你 没半 毛钱 关系 。 
i can come at three . 	我 三点 钟可 以来 。 
is there anything you can do ? 	有 什么 事是 你 能 做 的 吗 ？ 
che@@ ers ! 	干杯 ! 
you have already eaten the cake . 	你 已经 把 蛋糕 吃 了 。 
he finally became the president of i@@ b@@ m . 	他 最终 成 了 IBM 的 总裁 。 
can i drive the tra@@ ctor ? 	我能 开 拖拉机 吗 ？ 
what do you think i should wear on my date tomorrow ? 	你 觉得 我 明天 约会 穿 什么 好 呢 ？ 
it 's very hot today , is n't it ? 	今天 非常 热 ， 不是 吗 ? 
you used to be able to see the church from here . 	你 以前 可以 从 这里 看到 教堂 。 
there will be a math test tomorrow . 	明天 有 一个 数学 测验 。 
i 'm getting off at the next stop . 	我 将 在 下 一站 下车 。 
i 'd rather be with you . 	我 更 愿意 跟着 你 。 
tom said he loved me . 	汤姆 说 他 爱 我 。 
let me come in . 	让 我 进去 。 
can i borrow some money from you ? 	我 可以 向 你 借 一些 钱 ？ 
i found this at the risk of my life . 	我 冒 著 生命 危险 找到 了 这个 。 
tom is out of his mind . 	汤姆 失去 理智 了 。 
it 's been an ama@@ zing experience . 	这是 奇妙 的 体验 。 
he came home three hours later . 	他 三个 小时 后 回家 了 。 
three out of four americans believe in the exi@@ st@@ ence of par@@ an@@ or@@ mal ph@@ en@@ o@@ men@@ a . 	四分 之三 的 美国 人 相信 存在 超自然 现象 。 
tom saw the file . 	汤姆 看 了 文件 。 
tom needs mary 's help . 	汤姆 需要 玛丽 的 帮助 。 
do you know how to drive a car ? 	您 会 开车 吗 ？ 
i do n't know what tom got . 	我 不 知道 汤姆 拿到 了 甚么 。 
do n't bother me . 	别来 烦 我 。 
your father is tall . 	你 爸爸 很 高 。 
what time do you leave for school ? 	你 几点 钟去 学校 ？ 
their house is being remo@@ del@@ ed . 	他们 的 房子 正在 装潢 。 
cds have taken the place of records . 	CD 已经 取代 了 胶木 唱片 。 
i did n't like it . 	我 没有 喜欢 过 。 
you ought to know better at your age . 	在 你 这个 年纪 你 应该 要 更 懂事 。 
he is likely to be late again . 	他 可能 又 迟到 了 。 
i would like to speak english fluently . 	我 想 把 英语 说 得 很 流利 。 
he went on reading the book as if nothing had happened . 	他 继续 读书 ， 好像 什么 事 也 没有 发生 。 
tom told me what to say . 	汤姆 告诉 我 该 说 什么 。 
what happened to tom could happen to you . 	汤姆 身上 发生 的 事 也 可能 发生 到 你 身上 。 
i ca n't wait for you . 	我 不能 等 你 。 
he left an hour ago . 	他 一 小时 前 走 了 。 
it is absolutely impossible to do so . 	绝对 不 可能 这样 做 的 。 
he is like his father . 	他 像 他 父亲 。 
he does n't have a job . he 's retired . 	他 没有 工作 ， 他 退休 了 。 
where do i have to change trains ? 	我要 在 哪里 换 火车 ？ 
scary movies will fri@@ gh@@ ten the children . 	恐怖片 会 吓 到 小孩 。 
give it back . 	还 回去 
rain prevented us from taking a walk . 	雨 让 我们 没有 办法 去 散步 。 
i 'll definitely vote for tom . 	我 一定 要 给 汤姆 投票 。 
she was accused of telling a lie . 	她 被 指责 说 了 谎 。 
tom is always late . 	汤姆 总是 迟到 。 
he had plenty of fight left in him . 	他 的 胸中 还有 足够 的 斗志 。 
it all depends on the weather . 	一切 都 取决于 天气 。 
these dogs are big . 	这些 狗 很大 。 
i want to eat something delicious . 	我 想 吃 点 好吃 的 。 
i was nine years old when i asked my mom if santa cla@@ us really exi@@ sted . 	我 九岁 的 时候 问 我 妈妈 圣诞老人 是否 真的 存在 。 
that was n't my intention . 	这 不是 我 的 初衷 。 
maybe next time . 	也许 下 一次 吧 。 
you are a student . 	您 是 学生 。 
i asked for a table over there . 	我 在 那里 要 了 一张 桌子 。 
do you have a dictionary ? 	你 有 字典 吗 ？ 
several cot@@ ta@@ ges have been i@@ so@@ lated by the flood water . 	好 几间 小屋 被 洪水 孤立 起来 了 。 
call the police ! 	叫 警察 ！ 
interest rates are still low . 	利率 还是 低 。 
i was in school yesterday morning . 	昨天 上午 我 在 学校 。 
tom is the tallest in his family . 	汤姆 是 他 家里 最高 的 。 
i know that money is n't everything . 	我 知道 金钱 不 代表 一切 。 
i was kept waiting for nearly half an hour . 	我 等 了 接近 半 小时 。 
i have many abi@@ li@@ ties . 	我 有 很多 才能 。 
i admire you . 	我 欣赏 你 。 
do you have any plans for saturday ? 	你 周六 有 什么 计划 ？ 
how much of what i 've written here do you understand ? 	你 了解 多少 我 写 在 这里 的 东西 ? 
control is everything . 	控制 就是 一切 。 
let me think . 	让 我 想 一想 。 
it 's much more convenient . 	这 方便 得 多 了 。 
how long did you live there ? 	你 住 在 那里 多久 了 ? 
my son is now as tall as i am . 	我 儿子 现在 和 我 一样 高 了 。 
tom was like a member of our family . 	汤姆 像是 我们 家庭 的 一员 。 
not a star was to be seen . 	星星 没有 被 看到 。 
everyone was invited , except for me . 	除了 我 每个 人 都 被 邀请 了 。 
she went to the hospital yesterday . 	她 昨天 去 了 医院 。 
i waited for her for a really long time . 	我 真的 等 了 她 很长 一段 时间 。 
tennis is very popular among students . 	网球 在 学生 中 非常 流行 。 
they wash their hands with so@@ a@@ p . 	他们 用 肥皂 洗手 。 
we sometimes see them . 	我们 有时 会 看见 他们 。 
i have to go home . 	我该 回家 了 。 
i do n't quite follow you . 	我 听 不 太 懂 你 的 意思 。 
i ca n't find my suitcase . 	我 找 不到 我 的 手提箱 。 
i recognized some of the tun@@ es that tom played . 	我 认出 了 些 汤姆 演奏 的 调子 。 
london , where i live , used to be famous for its fog . 	我 住 的 地方 － 伦敦 ， 从前 以雾 闻名 。 
he had his hair cut short . 	他 把 头发 剪短 了 。 
get out of bed ! 	起床 ! 
how much is the rent per month ? 	一个月 的 租金 多少 ？ 
i have absolu@@ te trust in you . 	我 绝对 信任 你 。 
i support you who@@ le@@ -@@ hear@@ te@@ dly . 	我 全心全意 地 支持 你 。 
money is n't the only thing that matters . 	不 只是 钱 关系 重大 。 
what is my room number ? 	我 的 房间 号 是 多少 ？ 
school begins at 8@@ :30 a@@ .m . 	学校 在 上午 八点 三十分 开始 上课 。 
i 'm not accustomed to getting up early . 	我 不 习惯 早起 。 
i 'd very much like to go . 	我 非常 想 离开 。 
you should make good use of this opportunity . 	你 要 好好 把握 这个 时机 。 
everything matters . 	任何 事情 都 是 重要 。 
it seems that i 've lost my keys . 	我 好像 丢 了 我 的 钥匙 。 
these pants fit me well . 	我 穿 这条 裤子 很 合身 。 
language is the means by which people communicate with others . 	语言 是 人们 与 他人 交流 的 手段 。 
we may be late for school . 	我们 上学 可能 会 迟到 。 
in this kind of weather , it 's best to stay home and not go outside . 	这种 天气 下 最好 待 在 家里 不要 外出 。 
there was a castle here many years ago . 	许多年 前 这里 有 一座 城堡 。 
we bought a comfortable new ar@@ m@@ chair . 	我们 买 了 张 舒适 的 扶手椅 。 
he made the most of his opportunities . 	他 尽力 地 利用 了 他 的 机会 。 
the captain is responsible for the safety of passengers . 	船长 要 为 乘客 安全 负责 。 
there 's no need to hurry . 	没有 必要 著急 。 
i like being on the team . 	我 喜欢 在 队伍 里 。 
many of the workers died of hunger . 	许多 工人 死于 饥饿 。 
tom is still un@@ certain about whether to go to college or not . 	汤姆 还 不 清楚 要 不要 上 大学 。 
we 're getting a new car next month . 	下个 月 我们 会 有 辆 新车 。 
i 'm glad that i was able to help . 	能够 出 一份 力太好 了 。 
come whenever you want to . 	什么 时候 想来 就 过来 吧 。 
he asked the man to help him . 	他 叫 那个 男人 帮助 他 。 
she earns 30 dollars per day . 	她 每天 挣 30 美元 。 
he painted a picture of a dog . 	他 画 了 一幅 狗 的 画 。 
ac@@ t@@ ini@@ um was discovered by and@@ r@@ é@@ -@@ lou@@ is de@@ bi@@ er@@ ne in 18@@ 9@@ 9 . 	锕 在 1899 年 被 他 发现 。 
i visited him a week ago today . 	我 在 一周 前 的 今天 拜访 了 他 。 
give me a chance to make you proud of me . 	给 我 机会 来 让 你 为 我 感到 自豪 。 
do you like pi@@ rate movies ? 	你 喜欢 盗版 电影 吗 ？ 
do n't play baseball here . 	不要 在 这里 打 棒球 。 
i have decided to carry on the work . 	我 决定 继续 工作 。 
i see a cat cha@@ sing a dog . 	我 看见 一只 猫 追 着 一只 狗 跑 。 
who are we ? 	我们 是 谁 ？ 
i will give you anything you want . 	我会 给 你 任何 你 想要 东西 。 
it is up to you . 	由 你 来 决定 。 
what does your aunt do ? 	你 姑姑 是 做 什么 的 ？ 
i was able to find out his address . 	我能 找到 他 的 地址 。 
i 'm sorry that you are leaving here . 	我 很 遗憾 你 要 离开 这里 。 
you should try to form the habit of using your diction@@ ari@@ es . 	你们 该 养成 使用 字典 的 习惯 。 
life without love is just totally po@@ int@@ less . 	没有 爱情 的 生活 毫无 意义 。 
let me take your blood pressure . 	让 我量 量 你 的 血压 。 
the matter has not been settled yet . 	问题 还 没有 解决 。 
if you do n't hurry , you 'll miss the train . 	如果 你 不 抓紧 的话 ， 你 就 会 赶不上 火车 。 
his bag is right here , so he can not have gone to school yet . 	他 的 包 就 在 这儿 ， 所以 他 不 可能 已经 去 了 学校 。 
do n't believe everything you hear . 	不要 相信 你 听到 的 每件 事 。 
the clock stopped . 	钟停 了 。 
he has dozens of books about japan . 	他 有 几十 本 关于 日本 的 书 。 
my vacation went by quickly . 	我 的 假期 一下 就 过 完 了 。 
tom will do that . 	汤姆 会 做 。 
i will never forget your kindness . 	我 永远 不会 忘记 你 的 好意 。 
she 's sure to succeed . 	她 理所当然 的 取得 了 胜利 。 
what would you like to do in the future ? 	以后 打算 干什么 ？ 
i was almost hit by a car . 	我 几乎 被 车 撞 到 了 。 
we accept your cha@@ ll@@ en@@ ge . 	我们 接受 你们 的 挑战 。 
many people only speaks one language . 	许多 人 只 说 一种 语言 。 
i do n't have a computer at home . 	我家 没有 电脑 。 
he was caught ch@@ eating in the exam . 	他 在 考试 中 作弊 时 被 抓 到 了 。 
tom will never see you again . 	汤姆 以后 再也 不会 见 你 了 。 
how is it at school ? 	学校 怎么样 ？ 
this lake is deepest at this point . 	这里 是 湖 最深 的 地方 。 
have you finished your homework ? 	你 做 完 作业 了 吗 ？ 
i made efforts to improve my grades . 	我 努力 的 改善 我 的 成绩 。 
she got good grades in english . 	她 在 英文 上 取得 了 很 好 的 成绩 。 
i do n't have a computer . 	我 没有 电脑 。 
tom is a politician . 	汤姆 是 位 政治家 。 
do i need sur@@ ger@@ y ? 	我 需要 做 手术 吗 ？ 
people should get more involved . 	人们 需要 更 多 的 交流 。 
what 's the meaning of this ph@@ ra@@ se ? 	这个 片语 是 什么 意思 ？ 
let us know whether you can come . 	让 我们 知道 你 是否 能来 。 
if possible , i 'd like to travel around the world . 	如果 可能 的话 ， 我 想 环游 世界 。 
i was in boston last month . 	我 上个月 在 波士顿 。 
i 'm playing baseball . 	我 在 打 棒球 。 
i am eating rice . 	我 在 吃 米饭 。 
i do not like tea , so i generally drink coffee for breakfast . 	我 不 喜欢 茶 ， 所以 我 早餐 大致 上 都 喝 咖啡 。 
it 's a very sad story . 	这是 一个 非常 悲伤 的 故事 。 
he stuck to his promise . 	他 信守 了 承诺 . 
help me pe@@ el the potatoes . 	帮 我 削 一下 土豆 。 
we wo n't get paid extra for doing this . 	我们 做 这事 没有 额外 报酬 。 
he is older than she is by three years . 	他 比 她 大 三岁 。 
the fastest way to travel is by plane . 	旅行 最快 的 方式 是 乘 飞机 。 
i 've missed another chance . 	我 又 失去 了 一次 机会 。 
he 's a successful busin@@ ess@@ man . 	他 是 个 成功 的 商人 。 
i like red wine better than white wine . 	我 喜欢 红葡萄酒 胜过 白葡萄酒 。 
tom is buying some flowers for mary . 	汤姆 在 给 玛丽 买花 。 
zero comes before one . 	零在 一 前面 。 
i 'm wet . 	我 湿 了 。 
they are all innocent children . 	他们 都 是 天真 的 孩子 。 
there is a certain amount of truth in what he 's saying . 	他 说 的话 有 一定 的 道理 。 
mary succeeded in her studies . 	玛丽 在 研究 上 成功 了 。 
can i see the menu , please ? 	麻烦 给 我 菜单 。 
i wonder if they 'll get divorced . 	我 不 知道 他们 是否 会 离婚 。 
he gave her a piece of paper . 	他 给 了 她 一张 纸 。 
i find politics very interesting . 	我 对 政治 很 感兴趣 。 
tom is out of your lea@@ gue . 	汤姆 不 在 你 的 联盟 里 。 
yes , i have student id . 	是 的 ， 我 有 学生证 。 
i 've gotten better . 	我 已经 变得 好多 了 。 
i thought that you wanted to see me . 	我 以为 你 想见 我 呢 。 
i think tom is sleeping . 	我 以为 汤姆 在 睡觉 。 
can you find it ? 	你 能 找到 它 吗 ？ 
i do n't go to school on sunday . 	我 周日 不去 学校 。 
i 'd like to try on this dress . 	我 想 试穿 这件 衣服 。 
how about going out for dinner ? 	出去 吃 晚餐 如何 ？ 
i learned to drive a car and got a driver 's license when i was eighteen . 	我 十八岁 时 ， 学了 开车 、 考到 了 驾照 。 
she won everything . 	她 赢得 一切 了 。 
tom needed treat@@ ment . 	汤姆 需要 接受 治疗 。 
i went fishing last monday . 	上个 周一 我 去 钓鱼 了 。 
his mother came to pick him up . 	他 的 母亲 来接 他 了 。 
short skirts are already out of fashion . 	短裙 已经 过时 了 。 
she accused me of making a mistake . 	她 指责 我犯 了 错 。 
my father died four years ago . 	我 的 父亲 四年 前 去世 了 。 
tell me which you want . 	告诉 我 你 想要 哪个 。 
how can i get to the station ? 	我 怎样 才能 到 火车站 ？ 
have you heard from him recently ? 	你 最近 有 他 的 消息 吗 ？ 
hey , your dog just bit me . 	嘿 ， 你 的 狗 刚 咬 了 我 。 
have you already rung the doorbell ? 	你 已经 按 门铃 了 吗 ？ 
she wrote to her parents at least once a week . 	他 给 父母 写信 至少 一周 一次 。 
they congratu@@ lated us on our victory . 	他们 祝贺 我们 的 胜利 。 
they were not listening to music . 	他们 没 在 听 音乐 。 
i 'm on a diet . 	我 在 节食 。 
she invited tom and me to the party . 	她 邀请 我 和 汤姆 去 派对 。 
i have lost my umbrella somewhere in the park . i have to buy one . 	我 的 雨伞 遗失 在 公园 里 某个 地方 。 我 必须 再 买 一把 。 
how strange ! 	真 奇怪 。 
the sim@@ pl@@ est way is often the best way to solve a problem . 	解决问题 最 简便 的 方法 往往 是 最好 的 办法 。 
father always says , `` do your best . '' 	父亲 总是 说 " 你 尽力而为 。 " 
i 'm not accustomed to such treat@@ ment . 	我 不 习惯 这样 的 待遇 。 
he is old enough to understand it . 	他 年纪 够 大 可以 了解 它 。 
why did n't you dance with him ? 	你 为什么 不 跟 他 跳舞 呢 ？ 
i 'll send a message to tom . 	我会 给 汤姆 发 信息 。 
valuable time has been lost . 	宝贵 的 时间 已 失去 。 
the teacher granted me permission to go home early . 	老师 允许 我 提前 回家 。 
you are selling him short . 	你别 小看 了 他 。 
it seems obvious that he is sick . 	似乎 很 明显 他病 了 。 
tom did n't have to thank me . 	汤姆 不必 谢 我 。 
do you like spinach ? 	你 喜欢 菠菜 吗 ？ 
she asked him to open the window . 	她 要求 他 打开 窗户 。 
he had the right idea . 	他 的 想法 是 对 的 。 
a huge mon@@ ster is coming down the mountain . 	从 山上 走来 一只 巨大 的 怪物 。 
the couple is walking hand in hand . 	这 对 夫妻 手 牵手 走路 。 
she found her purse under the desk . 	她 在 桌子 底下 找到 了 她 的 钱包 。 
tom wants to spend more time with his family . 	汤姆 想 多 把 时间 花 在 他 的 家庭 上 。 
he tried to concentrate on the letter . 	他 试图 把 注意力 集中 在 信上 。 
yesterday 's weather was n't very good . 	昨天 天气 不是 很 好 。 
he believes that he can pro@@ ve it . 	他 相信 他 能 证明 它 。 
are you a high school student ? 	你 是 高中生 吗 ? 
the criminal has not been caught yet . 	那个 犯人 还 没 被 抓 到 。 
what fruit do you like the best ? 	你们 最 喜欢 什么 水果 ？ 
it 's obvious that he lied . 	显然 地 他 撒 了 谎 。 
we hope tom is ok . 	我们 希望 汤姆 没事 。 
i study for 3 hours every day . 	我 每天 读书 三个 小时 。 
it was n't as expensive as i expected . 	它 没有 我 想像 的 那么 贵 。 
the bus is running about ten minutes late . 	公交车 晚点 了 十分钟 。 
which way should we go ? 	我们 应该 往 哪个 方向 走 ？ 
do you know why she 's so angry ? 	你 知道 她 为什么 这么 生气 吗 ？ 
so , what happened this time ? 	那么 ， 这次 发生 了 什么 ？ 
you 're lying , are n't you ? 	在 撒谎 吧 ？ 
tom is able to swim well . 	汤姆 游泳 可以 游得 很 好 。 
have you finished reading that book yet ? 	你 读完 那 本书 了 吗 ? 
a lot of houses were washed away by the flood . 	许多 房屋 被 洪水 冲走 了 。 
i will not attend the party . 	我 将 不 出席 派对 。 
the bridge is being repa@@ inted . 	这座 桥 正 被 重新 油漆 。 
an@@ ni@@ ver@@ s@@ ari@@ es are important . 	周年 纪念 很 重要 。 
tom has three older sisters . 	汤姆 有 三个 姐姐 。 
he was busy with his homework . 	他 忙于 做 功课 。 
the police arrested the suspect . 	警方 逮捕 了 嫌疑人 。 
there 's an old movie theater in town . 	城里 有 一家 古老 的 电影院 。 
the cab driver was n't seriously injured . 	出租车 司机 没有 受 重伤 。 
i 'm good at tennis . 	我 擅长 网球 。 
i got five hours sleep last night . 	我 昨晚 睡 了 五 小时 。 
my parents wo n't let me go out with boys . 	我 父母 不让 我 和 男生 约会 。 
kyoto depends on the tourist industry . 	京都 依赖 旅游业 。 
she went to the ta@@ k@@ as@@ u cl@@ ini@@ c . 	她 去 了 高须 诊所 。 
do n't let the dog come in . 	别 让 狗 进来 。 
this is the worst book i 've ever read . 	这 是 我 读过 的 书 里面 写 的 最差 的 一本 了 。 
now who 's going to help you ? 	现在 谁 要 帮 你 ？ 
how do you account for that ? 	你 怎样 作出 的 解释 ？ 
i have a bit of bad news . 	我 有 个 坏 消息 。 
the rumor turned out to be false . 	谣言 [ 最后 ] 证明 是 假 的 。 
how much time do you spend on facebook ? 	你 花 多少 时间 在 Facebook 上 ？ 
put the chair in front of the desk . 	把 椅子 放在 桌子 前面 。 
i 'm sorry , but i ca n't hear you well . 	对不起 ， 但 我 听 不 太 清楚 你 说话 。 
i fed the dog . 	我 喂 过 狗 了 。 
it was beginning to snow . 	开始 下雪 了 。 
i ca n't leave . 	我 不能 走 。 
she was sick in bed yesterday . 	她 昨天 卧病 在 床 。 
in a cri@@ sis , you must get in touch with your teacher . 	在 危险 的 时候 你 必须 跟 你 的 老师 联系 。 
no students were absent . 	没有 学生 缺席 。 
do you often travel abroad ? 	你 经常 出国 吗 ？ 
let 's sit on the grass . 	我们 坐在 草地 上 吧 。 
you worry too much about your weight . 	你 太 担心 您 的 体重 了 。 
he has three older sisters . 	他 有 三个 姐姐 。 
he convinced me of his innocence . 	他 让 我 相信 他 是 无辜 的 。 
do you know how to cook meat ? 	你 知道 怎么 煮 肉 吗 ? 
this old house is haunted . 	这个 老房子 闹鬼 。 
i speak swe@@ dish . 	我 说 瑞典语 。 
i do n't have the slightest idea . 	我 没有 丝毫 的 想法 。 
we 're going by train . 	我们 要 乘 火车 去 。 
half of these apples are rotten . 	这些 苹果 的 其中 一半 都 烂 了 。 
do you know anyone who 's not on facebook ? 	你 有 认识 没有 用 Facebook 的 人 吗 ？ 
my father likes strong coffee . 	我 父亲 喜欢 浓 咖啡 。 
i saw a beautiful water@@ fall there . 	我 看见 那儿 有个 很 美 的 瀑布 。 
i war@@ med myself in the bath . 	我 泡 了 个 澡 身体 暖和 起来 了 。 
are you sure that 's what you want ? 	你 确定 那 是 你 想要 的 吗 ？ 
has tom gone in@@ san@@ e ? 	Tom 疯 了 吗 ？ 
why do n't we go home ? 	我们 何不 回家 呢 ？ 
the letter was finished . 	信写 完 了 。 
try hard . 	努力 。 
i 'm afraid she may have the mu@@ m@@ ps . 	我怕 她 可能 得 了 腮腺炎 。 
we had a short vacation in february . 	2 月 我们 有个 短期 休假 。 
i just was n't paying attention . 	我 只是 没 注意 。 
she had the boys paint the house . 	她 要 男孩 们 粉刷 房子 。 
the clock has stopped . 	时钟 已经 停止 了 。 
prices have dropped recently . 	最近 物价 已经 下降 。 
milli@@ ons were affected that day . 	那天 有 数百万 人受 影响 。 
i made an apple pie for you . 	我 做 了 一个 苹果 派 给 你 。 
father told me to wash the car . 	爸爸 告诉 了 我 要 洗车 。 
i can see through your lies . 	我能 看穿 你 的 谎言 。 
it 's raining . 	下雨 了 。 
he ca@@ tches colds easily . 	他 很 容易 感冒 。 
the barber gave him a haircut . 	理发师 为 他理 了 头发 。 
the trees are green . 	树是 绿 的 。 
you swim better than me . 	你 游泳 游得 比 我 好 。 
he knocked on the door . 	他 敲 了 门 。 
tell me about some of the places you 've visited . 	给 我 说 说 你 去过 的 一些 地方 。 
father ran short of money and had to borrow some . 	父亲 缺钱 ， 所以 他 必须 去 借点 钱 。 
something must be wrong with the machin@@ ery . 	这个 机器 一定 有 什么 地方 不 对劲 。 
what prevented you from coming earlier ? 	什么 阻止 你 早点 来 了 ? 
what about you ? 	你们 呢 ？ 
i 'll pay you back next week . 	我 下周 去 还 你 钱 。 
tom ca n't cross the bor@@ der . 	Tom 没 办法 穿过 边界 。 
is it difficult eating with chop@@ sti@@ cks ? 	用 筷子 吃饭 难 吗 ？ 
he plays baseball tomorrow . 	他 明天 将 打 棒球 。 
how about eating out this evening ? 	今天 晚上 出去 吃 怎样 ？ 
apples were served as the dessert . 	苹果 被 用来 当作 甜点 。 
it 's very kind of you to help me . 	你 帮 我 真 好 。 
how 's the weather there ? 	那里 的 气候 怎么样 ? 
mother stays at home every day . 	妈妈 每天 待 在 家里 。 
you can use my dictionary . 	你 可以 用 我 的 字典 。 
eat a lot of vegetables . 	多吃点 蔬菜 。 
what else can this do ? 	这 还有 什么 能 做 的 ？ 
let 's as@@ su@@ me that 'll happen . 	让 我们 假定 那会 发生 。 
she re@@ sented being called a coward . 	她 对 被 称为 懦夫 很 反感 。 
always be true to yourself . 	永远 要 对 自己 诚实 。 
i ate ca@@ vi@@ ar . 	我 吃 了 鱼子酱 。 
he does n't need to work . 	他 不 需要 工作 。 
it was n't a very interesting novel . 	这 不是 一个 很 有趣 的 小说 。 
we should tell children how to protect themselves . 	我们 应该 告诉 孩子 怎么 保护 自己 。 
are they actually friends ? 	他们 真是 朋友 吗 ？ 
i do n't worry about the risk . 	我 不 担心 风险 。 
you 're sick . you have to rest . 	你 病 了 ， 该 休息 了 。 
she got her daughter a personal computer . 	她 给 她 的 女儿 买 了 一台 个人电脑 。 
the bus was behind schedule . 	公交车 迟到 了 。 
it turned out that the rumor was false . 	谣言 [ 最后 ] 证明 是 假 的 。 
i have not yet finished my supper . 	我 还 没 吃 完 晚饭 。 
do you think that he is equal to the task ? 	你 认为 他 能够 胜任 这个 任务 吗 ? 
she has to take a reme@@ di@@ al course in english . 	她 需要 上 英语 补习班 。 
i 'm just looking . 	我 只是 随便 看看 。 
it is difficult to give up smoking . 	戒烟 很难 。 
they changed the system . 	他们 改变 了 制度 。 
tom did well considering his age . 	考虑 到 他 的 年纪 ， 他 做 得 很 好 。 
english is by far the most wi@@ del@@ y@@ -@@ spoken language in the world . 	英语 是 目前 在 世界 上 使用 最 广泛 的 语言 。 
they got married and settled near boston . 	他们 结了 婚 并 定居 在 波士顿 附近 。 
he looked for every possible means of escape . 	他 寻找 一切 可能 的 逃生 途径 。 
there is a bus every 20 minutes . 	每 20 分钟 有 一 班车 。 
this dog eats almost anything . 	这 只 狗 几乎 吃 任何 东西 。 
what 's wrong with your dog ? 	你 的 狗 怎么 了 ？ 
he wants to pay off his loan . 	他 想 还清 贷款 。 
he broke up the chair for fire@@ wood . 	他 摔断 了 椅子 当 柴火 。 
she applied her mind to her new job . 	她 专注 在 她 的 新 工作 上 。 
i like jogging . 	我 喜欢 跑步 。 
our native language is japanese . 	我们 的 母语 是 日语 。 
man is the only animal that can speak . 	人 是 唯一 会 说话 的 动物 。 
you may use my new car . 	你 可以 使用 我 的 新车 。 
is this a du@@ ty-@@ free shop ? 	这是 一间 免税 商店 吗 ？ 
how about another round ? 	再来 一轮 怎么样 ？ 
tom 'll wait . 	汤姆 会 等 。 
tom said he 'll ask mary to do that . 	汤姆 说 他 会 让 玛丽 去 做 。 
he has a lot of books on history . 	他 有 很多 历史 书籍 。 
tom is leaving kobe tomorrow morning . 	汤姆 明天 早上 离开 神户 。 
i 'll drop by the post office on the way home . 	我会 在 回家 的 路上 顺便 去 邮局 。 
the couple had a son . 	这 对 夫妇 生 了 个儿 子 。 
he spoke very loudly . 	他 说 得 很 大声 。 
you should have refused his offer . 	你 应该 拒绝 他 的 提议 的 。 
a fire broke out after the earthquake . 	地震 之后 发生 了 火灾 。 
everyone is waiting for tom . 	每个 人 都 在 等 汤姆 。 
she is what we call a book@@ worm . 	她 就是 所谓 的 书虫 。 
i ca n't focus on two things at the same time . 	我 不能 同时 注意 两件 事 。 
remember to mail this letter . 	记得 要 去 寄 这 封信 。 
america likes to cla@@ i@@ m that it is a `` class@@ less '' soci@@ ety . 	美国 是 一个 自称 没有 社会 阶层 的 国家 。 
that architect bui@@ l@@ ds very modern houses . 	那个 建筑师 创建 了 非常 现代 的 房屋 。 
write your goals down . 	把 你 的 目标 写 下来 。 
she was in a hurry . 	她 在 赶 时间 。 
did you ever try ? 	你 试过 吗 ？ 
i understand your position perfectly . 	我 十分 理解 你 的 立场 。 
a drunk driver was responsible for the car accident . 	喝醉 的 驾驶员 对 车祸 有 责任 。 
food should be che@@ wed before being s@@ wal@@ lowed . 	食物 在 吞咽 前要 经过 咀嚼 。 
you 'll succeed if you try . 	如果 你 尝试 的话 ， 你 会 成功 的 。 
i 'd like to go skiing . 	我 喜欢 去 滑雪 。 
tom is not a friendly guy . 	汤姆 不是 个 友好 的 家伙 。 
as soon as i get to london , i 'll drop you a line . 	我 一到 伦敦 就 会 给 你 留言 的 。 
i prefer red wine to white wine . 	我 喜欢 红葡萄酒 胜过 白葡萄酒 。 
i found the co@@ mic book very interesting . 	我 发现 这本 漫画 书 非常 有趣 。 
she does n't like soccer . 	她 不 喜欢 足球 。 
give it to them . 	把 它 给 他们 。 
you 're just being ri@@ di@@ cu@@ lous . 	你 就是 荒唐 。 
can i eat this orange ? 	我能 吃 这 只 橙子 吗 ？ 
we were talking about something at that time , but i do n't remember what . 	我们 那时 在 谈论 事情 ， 但 我 不 记得 是 什么 了 。 
i 'm a teacher . 	我 是 个 老师 。 
he loves to fish . 	他 酷爱 钓鱼 。 
i had difficulty in sol@@ ving this problem . 	我 很 难 解决 这个 问题 。 
i had a little fever this morning . 	今天 上午 我 有 一点儿 发烧 。 
i am al@@ armed by your ir@@ responsible attitude . 	我 对 你 不负 责任 的 态度 感到 惊讶 。 
have you been to london before ? 	你 以前 去过 伦敦 吗 ？ 
i could n't remember ever having met her . 	我 不 记得 曾经 见 过 她 。 
that was pretty n@@ eat . 	那真 整洁 。 
does n't that change things ? 	那能 改变 甚么 吗 ？ 
they are pea@@ ce@@ -@@ loving people . 	他们 是 热爱 和平 的 人 。 
the th@@ under scared the children . 	雷声 吓 到 孩子 了 。 
listen to me , ok ? 	听 我 说 ， 好 吗 ？ 
how about some more roa@@ st beef ? 	再 多一些 烤 牛肉 怎么样 ? 
i ca n't get away from work now . 	我 现在 在 工作 无法 离开 。 
it is n't polite to stare at people . 	盯 著 人 看 是 不 礼貌 的 。 
tom is in prison for a crime he did n't comm@@ it . 	汤姆 为 他 不认 的 罪进 了 监狱 。 
i want something sweet . 	我要 一些 甜 的 东西 。 
he has no manners at all . 	他 一点 礼貌 也 没有 。 
what is your phone number ? 	你 电话号码 是 多少 ？ 
tom says he can communicate with the dead . 	Tom 说 他 可以 通灵 。 
you seem to be pre@@ ju@@ di@@ ced against ideas that come from foreign countries . 	你 似乎 对 来自 国外 的 想法 有 偏见 。 
they married when they were young . 	他们 在 还 很 年轻 的 时候 就 结婚 了 。 
she has traveled all over the g@@ lo@@ be . 	她 周游 世界各地 。 
tom has been really busy recently . 	汤姆 最近 相当 忙 。 
have you ever dedicated a song to the or@@ phan@@ s ? 	你 有没有 给 孤儿 献上 一首歌 呢 ？ 
that is use@@ less to me . 	那 对 我 没有 用处 。 
as far as i 'm concerned , she 's a complete stranger . 	她 对 我 来说 是 一个 完全 陌生 的 人 。 
he does n't like traveling by air . 	他 不 喜欢 搭 飞机 旅行 。 
what a good idea ! 	多好 的 主意 啊 ！ 
tom does n't have time . 	汤姆 没有 时间 。 
if two men always have the same opinion , one of them is un@@ necessary . 	如果 两个 人 总是 意见 相同 ， 那么 他们 其中 一个 就 没 必要 了 。 
i want to go home . 	我要 回家 。 
everyone likes tom . 	大家 都 喜欢 汤姆 。 
i swim once a week . 	我 每 周游 一次 泳 。 
europe has a smaller population than asia . 	欧洲 的 人口 比 亚洲 少 。 
the bread is n't fresh . 	面包 不 新鲜 。 
he has n't come yet . 	他 还 没来 。 
he arrived in tokyo yesterday . 	他 昨天 抵达 东京 。 
we talked about a variety of to@@ pics . 	我们 谈 了 各种 话题 。 
o@@ stri@@ ches ca n't fly . 	鸵鸟 不会 飞 。 
what do you think i was doing before ? 	你 觉得 我 之前 在 做 什么 ？ 
how many books do you read per month ? 	你 一个月 读 几 本书 ？ 
stock prices pl@@ un@@ ged to a record low . 	股票 价格 跌至 历史 新低 。 
i can start anytime . 	我 随时 可以 开始 。 
i ca n't figure him out . 	我 不 了解 他 。 
she felt like taking a walk . 	她 想 去 散步 。 
the danger is over . 	危险 已 过去 。 
sooner or later his luck will run out . 	迟早 他 的 运气 会用 完 。 
tom fell down . 	汤姆 摔倒 了 。 
we reached the top of the mountain . 	我们 到达 了 山顶 。 
do you know me ? 	你 还 认识 我 吗 ？ 
stay with us . 	和 我们 留在 一起 吧 ！ 
we ca n't go outside because it 's raining . 	因为 下雨 ， 我们 不能 出去 。 
he loves her . 	他 爱 她 。 
i 'm not disa@@ gree@@ ing with you . 	我 没有 反对 你 。 
i 'll do whatever you want me to do . 	无论 你 要 我 做 什么 ， 我 都 会 去 做 的 。 
the phone rang . 	电话 正在 响 。 
i 'm sorry , i forgot my homework . 	很 抱歉 我 忘 了 写作 业 。 
tom told me where he lived . 	汤姆 告诉 我 他 住 在 哪里 。 
he drank three bottles of beer . 	他 喝 了 三瓶 啤酒 。 
i ca n't stand his ar@@ rog@@ ance . 	我 受不了 他 的 傲慢 。 
ho@@ p in . 	跳 进来 。 
she is going to mount tate . 	她 将 去 立山 。 
it 's frozen hard . 	真的 很 冰冷 。 
where are your things ? 	你们 的 东西 在 哪里 ？ 
tom said he was sick . 	汤姆 说 他 病 了 。 
he made remarkable progress in english . 	他 的 英语 有 了 显著 的 进步 。 
these things are n't mine ! 	这些 东西 不是 我 的 ！ 
i have some english books . 	我 有 一些 英 文书 。 
tom encouraged his son to study french . 	汤姆 鼓励 他 儿子 学 法语 。 
he 's always running short of cash . 	他 总是 缺钱 。 
nice ti@@ ming . 	好 时机 。 
the doctor examined the pati@@ ents . 	医生 检查 了 病人 。 
tom has been driving all day . 	汤姆 整天 都 在 开车 。 
will you explain the rule to me ? 	你 能 帮 我 说明 一下 规则 吗 ？ 
tom is n't nearly as smart as he thinks he is . 	汤姆 并 不 像 他 自 认为 的 那么 聪明 。 
he is at home today . 	他 今天 在家 。 
he is the rich@@ est man on earth . 	他 是 世界 上 最 有钱 的 人 。 
a foreign language ca n't be ma@@ stered in a year or so . 	一个 外国 语言 无法 在 一年 左右 就 被 掌握 。 
tom knew when mary would be arri@@ ving . 	汤姆 知道 玛丽 什么 时候 来 。 
you 've got a great sense of humor . 	你 有 很 好 的 幽默感 。 
no one thinks tom will win the race . 	没人 认为 汤姆 赛跑 会 赢 。 
do you have enough food ? 	你 有 足够 的 食物 吗 ？ 
not all ali@@ ens are bad . 	不是 所有 外星人 都 坏 。 
you 'd better hurry . 	你 最好 快点 。 
tom is more active . 	汤姆 更 活跃 。 
i put some cream in my coffee . 	我 在 我 的 咖啡 里 放 了 一些 奶油 。 
did you know that before ? 	你 之前 知道 那个 吗 ？ 
i ca n't put up with this noise . 	我 不能 忍受 这个 噪音 。 
i 'm really scared of spiders . 	我 真怕 蜘蛛 。 
give us two kni@@ ves and four for@@ ks , please . 	请 给 我们 两把 刀 和 四 把 叉 。 
i ca n't remember . 	我记 不得了 。 
would you close the window ? 	请 您 把 窗户 关 起来 好 吗 ？ 
what time did your friend go home ? 	你 朋友 几点 钟 回家 ? 
tom is asleep on the couch . 	汤姆 在 长沙 发上 睡着 了 。 
i 'd like a window seat , please . 	请 给 我 靠 窗口 的 位子 。 
when does the movie start ? 	电影 什么 时间 开始 ？ 
my father goes to work by bike . 	我 父亲 骑 自行车 去 上班 。 
do you have any friends who are doctors ? 	你 有 朋友 是 医生 吗 ？ 
you broke the rules . 	你 触犯 了 规则 。 
we 're waiting for the right time . 	我们 在 等 对 的 时机 。 
he walks his dog every morning . 	他 每天 早晨 溜 狗 。 
nobody has seen god . 	没有 人 看过 神 。 
nobody would listen to me . 	没有 人会 听 我 说 。 
money does not grow on trees . 	钱 不会 从 树上 长 出来 。 
su@@ m@@ o is a tradi@@ tional japanese sport . 	相扑 是 日本 传统 的 体育 活动 。 
will you tell me how to get to shinjuku ? 	请问 你 可以 告诉 我 如何 可以 到达 新宿 吗 ？ 
i have to wake tom up . 	我 得 叫醒 汤姆 。 
he is always with me . 	他 一直 与 我 同 在 。 
i 'll do anything . 	我 不会 做 任何 事 。 
tom is in the at@@ tic . 	汤姆 在 阁楼 里 。 
the offer is too good to be turned down . 	此 提议 好 得 令人 难以 拒绝 。 
i 'm not afraid of anything . 	我 什么 都 不怕 。 
tom has no idea what to do with all the jun@@ k in his garage . 	汤姆 不 知道 拿 他 车库 的 那些 废物 怎么办 。 
i do n't sleep in a bed . 	我 不 在 床上 睡觉 。 
he 's very smart , and he 's handsome too . 	他 很 聪明 ， 而且 他 很帅 。 
i went for a walk in the park . 	我 去 公园 散 了 步 。 
it 's fun to ride a motorcycle . 	骑 摩托车 很 有趣 。 
tom certainly is an interesting person . 	汤姆 这人 确实 很 有意思 。 
let me remind you again that march 3@@ 1@@ st is the due date . 	让 我 再次 提醒 你 3 月 31 日 是 到期日 。 
he is an italian . 	他 是 义 大利 人 。 
i want to go there . 	我 想 去 那里 。 
she speaks chinese . 	她 讲 中文 。 
how much does this cost ? 	多少 钱 ？ 
he bought me a new dictionary . 	他 买 给 我 一本 新 字典 。 
they have nothing to eat . 	他们 没有 东西 吃 了 。 
i love going to the movies . 	我 喜欢 看 电影 。 
she has a bit of a bad temper . 	她 脾气 有点 坏 。 
am i wrong ? 	我错 了 吗 ？ 
why do n't you have some sushi ? 	为什么 不 尝尝 寿司 ？ 
why do people comm@@ it suicide ? 	为什么 人们 会 自杀 ? 
speech is silver , but silence is go@@ ld@@ en . 	雄辩 如银 ， 沉默 如金 。 
we had a heated discussion about it . 	我们 激烈 的 讨论 了 这个 问题 。 
just pull the door shut . it 'll lock by itself . 	只要 推门 就 好 了 。 它 自己 会 锁上 的 。 
tom has blue eyes . 	汤姆 的 眼睛 是 蓝色 的 。 
between you and me , tom 's idea does n't app@@ eal to me very much . 	汤姆 的 主意 我 不 太 感兴趣 ， 这个 我们 之间 说 说 就 好 。 
she 's leaving the country in six months . 	她 半 年后 就要 出国 了 。 
my parents have gone to the airport to see my uncle off . 	我 父母 去 机场 送 我 叔叔 了 。 
can i ask a question ? 	我能 问个 问题 吗 ？ 
just say no . 	只要 说 不 。 
do you believe in god ? 	你 相信 上帝 吗 ？ 
i 'm sorry . i got the wrong number . 	对不起 ， 我 拿 错 了 号码 。 
eating raw eggs could be bad for you . 	吃 生蛋 可能 是 危险 的 。 
are you really willing to help ? 	你 是 真的 很 乐意 帮忙 吗 ? 
tom does n't want our help . 	汤姆 不想 让 我们 帮忙 。 
please open the door . 	请 开门 。 
he said nothing , which made her angry . 	他 什么 也 没 说 ， 这 让 她 很 生气 。 
i got it free . 	我 是 免费 得到 的 。 
i can understand you to some extent . 	在 某种 程度 上 我 能 了解 你 。 
tom told me that he 'd like to become a doctor . 	汤姆 告诉 我 他 想 当 医生 。 
i was tired , so i did n't go . 	我累 了 ， 所以 我 没 去 。 
she found a job as a typi@@ st . 	她 找到 了 一份 打字员 的 工作 。 
hey guys , please be quiet . 	嗨 ， 请 保持 安静 。 
swi@@ tch on the light . i ca n't see anything . 	把 灯 打开 。 我 什么 都 看 不见 了 。 
we just have enough time to eat breakfast . 	我们 刚好 有 时间 吃 早饭 。 
during the exam , tom cheated off mary . 	在 考试 的 时候 ， 汤姆 作弊 抄 了 玛丽 的 答案 。 
what we had to do was really quite simple . 	我们 要 做 的 很 简单 。 
are they treated fairly ? 	他们 受到 公正 对待 了 吗 ？ 
grab a hold of the rope . 	抓住 绳子 。 
i remember seeing him . 	我 记得 见 过 他 。 
you are always late . 	你 总是 迟到 。 
she eats nothing but vegetables . 	她 只 吃 蔬菜 。 
have you seen my glasses anywhere ? 	你 曾 在 哪里 看到 过 我 的 眼镜 吗 ？ 
cherry blo@@ sso@@ ms are very beautiful . 	樱花 非常 漂亮 。 
i do n't have much time . 	我 时间 不多 。 
i like playing baseball . 	我 喜欢 打 棒球 。 
tom learned how to do that from his grandfather . 	汤姆 从 他 祖父 那里 学会 了 怎么 做 。 
is this the bus for park ri@@ dge ? 	这 是 去 帕克 里奇 的 巴士 ？ 
your wife is mad at you . 	你 太太 在 生 你 的 气 。 
are we going to lose ? 	我们 将会输 了 吗 ？ 
this book is small . 	这 本书 小 。 
did you hear about what 's happened to tom ? 	你 有没有 听说 汤姆 出 了 什么 事 ？ 
this is not important . 	这个 不 重要 。 
his pictures were hung on the wall . 	他 的 画 被 悬挂 在 墙上 。 
tom drank his orange juice . 	Tom 喝 了 他 的 柳 橙汁 。 
i 've enjoyed reading this novel . 	我 喜欢 读 这本 小说 。 
problems that can be solved with money are not real problems . 	钱 可以 解决 的 问题 都 不是 问题 。 
are you going to visit any other countries ? 	你 会 去 访问 其他 国家 吗 ？ 
can i get my money back ? 	我 是不是 能 收回 我 的 钱 ？ 
you 'll understand later . 	你 晚 一会 就 能 明白 。 
the situation is worse than i thought . 	情况 比 我 想 的 还 坏 。 
take a picture with your phone . 	用 你 的 手机 拍 一张 照片 。 
new stamps will be issu@@ ed next month . 	新 邮票 将 于 下个 月 发行 。 
who found my bag ? 	谁 找到 了 我 的 包 ？ 
i always enjoy listening to classical music in my free time . 	有空 的 时候 ， 我 总 喜欢 听 古典 音乐 。 
all three of you are very lucky . 	你们 三个 很 走运 。 
i understand how to solve the problem . 	我 知道 怎么 解决 这个 问题 。 
i wanted to cry . 	我 想 哭 。 
people should be dancing . 	人们 应该 在 跳舞 。 
classes begin next week . 	课程 下周 开始 。 
i ca n't go , nor do i want to . 	我 去 不了 ， 也 不想 去 。 
i 'd better do it right now . 	我 马上 做 比较 好 。 
spring will come soon . 	春天 就要 来 了 。 
i stayed at his place yesterday . 	我 昨天 住 在 他家 。 
tom comes here three or four times a month . 	汤姆 一个月 来 这里 三四次 。 
i go to school . 	我 去 学校 。 
did you have a good time yesterday ? 	你 昨天 玩得 开心 吗 ? 
wait till the light turns green . 	等到 指示灯 变成 绿色 。 
why were you late ? 	你 为什么 迟到 ？ 
what are you puni@@ shing them for ? 	你 为什么 惩罚 他们 ？ 
my room faces east . 	我 的 房间 面向 东边 。 
what do you usually do after dinner ? 	你 通常 晚 饭后 做 什么 ? 
she pretended that she was sick . 	她 假装 生病 了 。 
do you still need tea ? 	你 还 需要 茶 吗 ？ 
the lock is broken . 	锁坏 了 。 
if he is innocent , then his wife is guilty . 	如果 他 是 清白 的 ， 那 他 妻子 就 有罪 。 
he is my type ! 	他 是 我 的 菜 ! 
years passed . 	多少 年 过去 了 。 
america did away with sla@@ very . 	美国 废除 了 奴隶制度 。 
he pretended to be my friend . 	他 假装 是 我 的 朋友 。 
he objected to his wife working outside . 	他 反对 妻子 在外 工作 。 
the news made her sad . 	这个 消息 让 她 很 伤心 。 
he was a very good ski@@ er when he was little . 	他 年轻 时 很会 滑雪 。 
she is an ob@@ stin@@ ate girl . 	她 是 个 倔强 的 女孩 。 
i was n't drunk . 	我 没醉 。 
are you free on tuesday ? 	周二 你 有空 吗 ？ 
tom is waiting for you in the conference room . 	汤姆 在 会议室 等 你 。 
the meeting will be held tomorrow . 	会议 将 于明 天 举行 。 
tom and mary are very hungry . 	汤姆 和 玛丽 很 饿 。 
that only happens occasionally . 	这 只是 偶发 事件 。 
tom ca n't afford this . 	汤姆 买不起 这个 东西 。 
i 've just finished eating breakfast . 	我刚 吃 完 了 早饭 。 
the sum of 5 and 3 is 8 . 	五 和 三 的 总和 是 八 。 
hang on . 	坚持 。 
he admitted his guilt . 	他 承认 他 有罪 。 
he painted a dog . 	他 画 了 一只 狗 。 
what language is spoken in america ? 	在 美国 的 人 说 什么 语言 ? 
the leaves of the trees in the garden have turned completely red . 	花园里 树上 的 叶子 已经 完全 变红 了 。 
please close the door . 	请 关门 。 
i 'd like something to eat . 	我 想 吃 点 东西 。 
it is likely to rain again . 	很 有 可能 还会 下雨 。 
that woman is much older than i am . 	那 女人 比 我 老 很多 。 
could you please lend me thirty dollars ? 	请问 你 能 借给 我 三十 美圆 吗 ？ 
i 'm looking for a place to sit . 	我 正在 找个 地方 坐下 。 
i think it wo n't rain tomorrow . 	我 认为 明天 不会 下雨 。 
tom was con@@ serva@@ tive . 	汤姆 过去 很 保守 。 
what 's the weight of your suitcase ? 	你 的 行李 多重 ？ 
how much will it cost you to go by air ? 	坐 飞机 将 花 你 多少 钱 ？ 
i know none of them . 	他们 中 的 任何 一位 我 都 不 认识 。 
b@@ lon@@ des ear@@ n 7 % more than women with any other hair color . 	金发 女郎 比 其他 颜色 头发 的 女人 多 赚 7 ％ 。 
where did you have your picture taken ? 	你 从 哪里 照 的 相 ？ 
you just saved me a lot of time . 	你 省 了 我 好多 时间 。 
she went for a walk . 	她 去 散步 了 。 
the people of london are very proud of this bridge . 	伦敦 人 对 这座 桥 感到 非常 自豪 。 
we can change if we want to . 	如果 我们 想 ， 我们 就 能 变 。 
when will it start ? 	什么 时候 开始 ？ 
it was not until i reached home that i missed my purse . 	那 是 在 我 到 家 以后 ， 我 才 不见 了 我 的 钱包 。 
can i sleep here ? 	我能 在 这里 睡觉 吗 ？ 
do you think i 'm joking ? 	你 觉得 我 是 在 开玩笑 吗 ？ 
it is an endangered species . 	这是 一个 濒临 灭绝 的 物种 。 
she has a pur@@ e heart . 	她 有 一颗 纯洁 的 心 。 
can you free@@ ze it ? 	你 能 冷冻 它 吗 ？ 
everyone in the room checked their watches at the same time . 	房间 里 的 所有人 都 同时 看 了 看 自己 的 手表 。 
he did all he could to protect his son . 	他 做 了 一切 能 做 的 去 保护 他 的 儿子 。 
they are leaving in three days , that is to say june 10@@ th . 	他们 将 在 三天 后 离开 , 那 也就是说 在 六月 十日 。 
i asked her for a date . 	我 向 她 提出 约会 的 请求 。 
he likes both music and sports . 	他 喜欢 音乐 和 运动 。 
the movie theater was filled with people . 	这家 电影院 挤满 了 人 。 
would you give me a h@@ int ? 	你 可以 给 我 一个 提示 吗 ？ 
tom is accustomed to getting up early . 	汤姆 习惯 早起 。 
this is a stupid de@@ sign . 	这份 设计 很蠢 。 
he made the best of the opportunity . 	他 善用 了 这个 机会 。 
there are many earthquakes in japan . 	日本 有 许多 地震 。 
i 'm very tired , but i ca n't get to sleep . 	我 很 累 ， 但 我 还是 没 办法 入睡 。 
i warned him , but he ignored the war@@ ning . 	我 警告 过 他 ， 但 他 不 理会 警告 。 
the bar@@ gain sale will run for three days , beginning today . 	这场 减价 活动 会 持续 三天 ， 从 今天 开始 。 
tom s@@ nick@@ ered at mary . 	汤姆 暗中 笑 玛丽 。 
you 're welcome . 	您 不必 感谢 我 。 
she has a real k@@ n@@ ack for getting people to do what she wants . 	她 真的 有 本事 让 别人 做 她 想 做 的 事 。 
did you eat at home before you came here ? 	你 来 之前 在 家里 吃饭 了 吗 ？ 
i really enjoyed myself tonight . 	今晚 我 玩 得 很 开心 。 
all the boys in class worked hard . 	课堂 上 所有 的 男生 都 很 用功 。 
what did he say ? 	他 说 了 什么 ？ 
i ca n't believe you are eating something the doctor has told you re@@ pea@@ te@@ dly you should n't eat . 	真的 不敢 相信 你 在 吃 医生 叮嘱 不要 食用 的 东西 。 
let 's get off here . 	我们 在 这里 下车 吧 。 
the lights are n't on . 	灯 没有 亮 着 。 
i ro@@ de my bicycle to the store . 	我 骑 了 我 的 自行车 去 商店 。 
are you saying tom 's hiding something from us ? 	你 说 Tom 对 我们 隐藏 了 一些 事情 ？ 
it 's almost time to go to bed . 	差不多 是 就寝 的 时间 了 。 
where is the pain ? 	哪里 痛 ？ 
you look pale today . 	你 今天 看上去 很 苍白 。 
we got the meeting over with quickly . 	我们 很快 的 结束 了 这个 会议 。 
i 've changed my website 's la@@ you@@ t . 	我 改 了 一下 我 的 网站 的 布局 。 
i need advice . 	我 需要 些 建议 。 
somebody has stolen my hair dryer . 	有人 偷 了 我 的 吹风机 。 
he att@@ ri@@ bu@@ tes his success to good luck . 	他 将 他 的 成功 归功 于 好运 。 
the child has a case of chicken po@@ x . 	这 孩子 有 水痘 的 症状 。 
i need you here . 	我 需要 你 在 这里 。 
i hate chemistry . 	我 讨厌 化学 。 
tom has never been in prison . 	汤姆 从没 进过 监狱 。 
we took turns driving . 	我们 轮流 开车 。 
it 's pretty simple . 	它 真 简单 。 
tom wanted to stay home and relax instead of hi@@ king with his children . 	汤姆 想待 在家 休息 而 不是 和 他 的 孩子 们 出去 远足 。 
`` where were you ? '' `` i was at a friend 's house . '' 	“ 你 在 哪里 ？ ” “ 我 在 一个 朋友家 。 ” 
what do you think of this sweater ? 	你 觉得 这件 毛衣 怎么样 ？ 
we have am@@ ple time to catch our train . 	我们 有 充裕 的 时间 赶上 火车 。 
i 'm at home . 	我 在家 。 
tom passed away on october 20 , 20@@ 1@@ 3 . 	汤姆 逝世 于 2013 年 10 月 20 日 。 
tom knows that i do n't like him . 	汤姆 知道 我 不 喜欢 他 。 
he came home late last night . 	他 昨晚 很晚 回家 。 
what time is it ? 	几点 了 ？ 
he does n't know english at all . 	他 一点 也 不 懂 英语 。 
i did nothing out of the ordinary . 	我 没 做 什么 与众不同 的 事 。 
she was very proud of her father . 	她 为 她 的 父亲 感到 非常 骄傲 。 
when did you begin studying english ? 	您 什么 时候 开始 学 英语 的 ？ 
the artist who illu@@ strated this book is very good . 	给 这本 书画 插画 的 画家 很 好 。 
i 'm afraid i ca n't help you . you must ask someone else . 	我 担心 可能 帮不了 你 ， 你 需要 找 其他人 帮忙 。 
tom is wearing the same clothes he wore yesterday . 	汤姆 穿着 跟 昨天 穿 的 衣服 。 
she gave birth to twin girls . 	她 生 了 双胞胎 女儿 。 
do you think it 's a sign ? 	你 认为 这 是 个 预兆 吗 ？ 
put your hands up ! 	手举 起来 。 
she does n't want to talk about it . 	她 不想 提了 。 
please find a solution to the problem . 	请 找到 问题 的 解决 方法 。 
he likes anything sweet . 	他 喜欢 一切 甜 的 东西 。 
take your hat off when you enter a house of wor@@ ship . 	当 你 进入 礼拜堂 时 ， 把 你 的 帽子 脱 下来 。 
are you on the committee ? 	你 是 委员会 中 的 成员 吗 ？ 
tom , i want you to handle this one . 	汤姆 ， 我 想要 你 来 操作 这 一个 。 
it 's better than nothing . 	有 比 没有 好 。 
soccer is my favorite sport . 	足球 是 我 最 喜欢 的 运动 。 
one thousand dollars will cover all the expen@@ ses for the party . 	1000 美元 将 负担 聚会 的 全部 费用 。 
tom y@@ aw@@ ned . 	汤姆 打哈欠 了 。 
com@@ b your hair before you go out . 	在 你 出门 之前 ， 把 你 的 头发 梳一 梳 。 
i really did n't even notice . 	我 真的 根本 没 注意 到 。 
could i have a subway map , please ? 	给 我 一张 地下 铁 的 路线图 好 吗 ？ 
we ca n't sit i@@ dly by . 	我们 不能 光坐 著 。 
the young girl burst into tears . 	这个 年轻 的 女孩 泪流满面 。 
a foreign language can not be ma@@ stered in a year or so . 	一个 外国 语言 无法 在 一年 左右 就 被 掌握 。 
another sco@@ tch and water , please . 	麻烦 再来 一杯 威士忌 和 加水 。 
this food does not agree with me . 	这 食物 不 适合 我 。 
who is the woman dressed in p@@ ink ? 	那个 穿 粉红色 衣服 的 女人 是 谁 ？ 
it 's very special . 	它 很 特别 。 
you can take today off . 	你 今天 可以 休假 一天 。 
i 'll open the window a bit . 	我 把 窗户 打开 一点 。 
for the other 6@@ 00 million people , english is either a second language or a foreign language . 	对于 其他 的 六 亿 人口 而言 ， 英语 不是 第二 语言 就是 外语 。 
he 's coming clo@@ ser . 	他 在 靠近 。 
what am i to do now ? 	怎么办 ? 
tom is a c@@ lever kid . 	汤姆 是 聪明 的 孩子 。 
i gave it to my mo@@ mmy . 	我 给 我 妈 了 。 
we are anxious about her safety . 	我们 为 她 的 安全 担忧 。 
i want to study abroad next year . 	我 明年 想 出国 留学 。 
let 's take turns row@@ ing the boat . 	让 我们 轮流 划船 。 
he was afraid of being laughed at . 	他 怕 被 嘲笑 。 
it 's already time to go home . 	已经 是 时候 回去 了 。 
please do n't use my name . 	请 不要 用 我 的 名字 。 
do you often travel abroad ? 	你 经常 去 国外 旅行 吗 ？ 
she finally reached the hotel . 	她 终于 到达 了 酒店 。 
no one else was hurt . 	没有 别的 人 受伤 。 
he decided not to go to the party . 	他 决定 不要 去 派对 了 。 
tom lives near me . 	汤姆 住 在 我 的 附近 。 
that 's what i want . 	那 就是 我 想要 的 。 
let me help you with your work . 	让 我 帮 你 做 你 的 工作 。 
how interesting ! 	多么 有趣 啊 ！ 
i 'd like to see your sister . 	我 想见 你 的 姐姐 。 
who is the secretary ? 	谁 是 秘书 ？ 
the audience was very large . 	观众 人数 庞大 。 
i 'd like to talk about your situation . 	我 想 谈谈 你 的 情况 。 
this boat sa@@ ils through the stra@@ it of gi@@ bra@@ l@@ ta@@ r . 	这艘 船 航行 通过 了 直布罗陀海峡 。 
some@@ how i thought you 'd say that . 	我 就 知道 你 会 这么 说 。 
she gave up her plans against her will . 	她 违背 己愿 放弃 了 她 的 计划 。 
i went to dis@@ ne@@ y@@ land yesterday . 	昨天 我 去 了 迪士尼 乐园 。 
tom knows exactly how i like my hair done . 	汤姆 很 清楚 我 喜欢 什么样 的 发型 。 
i am proud of my father . 	我 为 我 父亲 而 自豪 。 
please make yourself at home . 	请 不要 客气 。 
i like you very much . 	我 非常 喜欢 你 。 
he lives next door to us . 	他 住 在 我们 隔壁 。 
i was in the bathroom . 	我 当时 在 卫生间 。 
they always skip school . 	他们 总是 逃学 。 
my father drives very well . 	我 父亲 开车 开得 非常 好 。 
i paid him a visit yesterday . 	我 昨天 去 见 他 了 。 
what he said would happen has happened . 	他 说 会 发生 的 事情 已经 发生 了 。 
what is the fare from osaka to a@@ ki@@ ta ? 	从 大阪 到 秋田 的 车费 是 多少 ？ 
please send this by registered mail . 	请用 挂号 寄 这个 。 
a plastic dish will me@@ lt on the sto@@ ve . 	塑料 盘子 在 烤箱 里会化 的 。 
tom ro@@ lled down his window . 	汤姆 拉下 了 他 的 窗户 。 
i ba@@ ked cookies . 	我 烤 了 曲奇 。 
please write with a pencil . 	请用 铅笔 写 。 
my grandfather died five years ago . 	我 祖父 五年 前 去世 了 。 
when did she break the window ? 	她 什么 时候 打破 了 窗户 ？ 
he is allergic to house dust . 	他 对 室内 灰尘 过敏 。 
tom whispered something to mary and she smiled . 	汤姆 小声 对 玛丽 说 了 什么 ， 玛丽 笑 了 。 
i went to the park last saturday . 	上个 星期六 我 去 了 公园 。 
you can no longer hurt me . 	你 不再 能 伤害 到 我 了 。 
they bought a box of cookies . 	他们 买 了 一盒 曲奇 。 
that was n't so hard , was it ? 	那 不难 ， 是 吧 ？ 
that 's soft . 	这 很 软 。 
i do n't like eggs . 	我 不 喜欢 鸡蛋 。 
i found this book interesting . 	我 觉得 这 本书 很 有意思 。 
will it take long to recover ? 	复原 需要 花 很长 的 时间 吗 ？ 
i 'll go with you as far as the bridge . 	我会 跟着 你 走 到 桥 那里 。 
follow us . 	请 跟着 我们 。 
please let me go . 	请 让 我 走 。 
she could n't answer the question . 	她 无法 回答 这个 问题 。 
absolutely nothing is per@@ man@@ ent in life . 	生活 中 绝对 没有 什么 是 持久 的 。 
you ought to see a dentist . 	你 应该 去 看 牙医 。 
i tried to stop that from happening . 	我试 着 阻止 它 发生 。 
i have a cough and a little fever . 	我 咳嗽 ， 还 有点 发烧 。 
there 's narrow road to the village . 	到 村庄 有条 窄 路 。 
i have n't yet finished my homework . 	我 还 没 做 完 作业 。 
nothing happened . 	什么 事 都 没有 发生 。 
do you have a po@@ ints card ? 	您 有 会员卡 吗 ？ 
i caught sight of a para@@ de on my way home . 	在 回家 的 路上 ， 我 看到 一场 阅兵式 。 
we consider it a ble@@ ssing . 	我们 把 它 当作 恩惠 。 
i ca n't live without you . 	没有 你 我活 不 下去 。 
london , the capital of england , is on the thames . 	英国 首都 伦敦 在 泰晤士河 畔 。 
never be afraid of making mistakes . 	不要 害怕 犯错 。 
tom mo@@ st@@ ly kept to himself . 	汤姆 大多 一个 人 独处 。 
i accept the offer . 	我 接受 了 报价 。 
that dog is only blind in one eye . 	那狗 一只 眼是 瞎 的 。 
i do n't appro@@ ve your decision . 	我 不 同意 你 的 决定 。 
i am a vege@@ tari@@ an . 	我 是 素食 主义者 。 
i 've been reading this for a few hours . 	我 一直 读 这个 读 了 几个 小时 。 
english is spoken in many countries . 	许多 国家 的 人 说 英语 。 
i got home at seven . 	我 七点 回到 家 。 
there are many people in the park . 	公园 里 有 很多 人 。 
i think it will be hot today . 	我 觉得 今天 会 很 热 。 
tom went into the kitchen and poured himself a cup of coffee . 	汤姆 进 了 厨房 ， 给 自己 倒 了 杯 咖啡 。 
i do n't have the address with me . 	我 身上 没带 这个 地址 。 
this is never going to end . 	这 将 永远 继续 下去 。 
sorry , i do n't have any change . 	不好意思 ， 我 没 零钱 。 
do n't leave your work half finished . 	别留 着 一半 工作 没干 。 
can you do book@@ kee@@ ping ? 	你会记 帐 吗 ? 
i do n't know when he 'll come again . 	我 不 知道 他 什么 时候 会 再 来 的 。 
i want to talk to your uncle . 	我 想 和 你 的 舅舅 谈一谈 。 
although the government refu@@ ses to admit it , its economic policy is in ru@@ ins . 	尽管 政府 拒绝 承认 ， 它 的 经济 政策 还是 失败 了 。 
tom did n't tell me his secret . 	汤姆 没有 告诉 我 他 的 秘密 。 
i do n't like this one . 	我 不 喜欢 这个 。 
stop reading . 	别 再念 了 。 
she ac@@ knowle@@ d@@ ged that my sta@@ te@@ ment was true . 	她 承认 我 的 声明 是 真实 的 。 
the strong wind indi@@ ca@@ tes that a storm is coming . 	强风 暗示 著 即将 到来 的 暴雨 。 
that would be re@@ lev@@ ant . 	那会 有 关系 。 
should we have some lunch ? 	我们 该 吃 午饭 了 吧 ？ 
do you study every day ? 	你们 每天 都 读书 吗 ？ 
he goes to london once a month . 	他 一个月 去 一次 伦敦 。 
i know that you think i 'm crazy . 	我 知道 你 觉得 我 疯 了 。 
we 're not going on vacation . 	我们 不去 度假 。 
we 're doing the best we can . 	我们 尽力而为 。 
tom wrote his name in the sand with a stick . 	汤姆 用 棍子 在 沙上 写 了 他 的 名字 。 
i hear you , but i do n't see you . 	我 听 得 见 你 ， 但 我 看 不见 你 。 
it 's hot today , is n't it ? 	今天 很 热 ， 不是 吗 ? 
please answer this question for me . 	请 回答 我 这个 问题 。 
i believe you 're honest . 	我 相信 你 是 诚实 的 。 
i do n't know if he can come tonight . 	我 不 知道 他 今晚 会 不会 来 。 
i hate ter@@ r@@ or@@ ist org@@ ani@@ z@@ ations . 	我 痛恨 恐怖主义 组织 。 
i wonder how many canadi@@ ans live in boston . 	我 在 想 有 多少 加拿大人 住 在 波士顿 。 
we should call the police . 	我们 该 报警 。 
tom has n't for@@ given anybody . 	汤姆 没 原谅 过 任何人 。 
are you aware of how much she loves you ? 	你 知道 她 有 多么 爱 你 吗 ? 
was his story true ? 	他 的 故事 是 真的 吗 ？ 
he kissed his daughter on the fore@@ head . 	他亲 了 亲 他 女儿 的 额头 。 
that accident was due to his careless@@ ness . 	那 事故 是 他 的 粗心 导致 的 。 
is this your first trip abroad ? 	这 是 你 第一次 出国 吗 ？ 
i 'll take your suitcase to your room . 	我会 把 你 的 手提箱 拿到 你 的 房间 。 
this car is easy to handle . 	这辆 车 很 容易 操控 。 
he never speaks unless spoken to . 	除非 有人 跟 他 说话 ， 他 从来不 说话 。 
what goes up must come down . 	会起 必会落 。 
i remember mailing the letter . 	我 记得 寄 了 信 。 
i 'm going to take a bath . 	我 打算 洗个 澡 。 
his parents expect too much of him . 	他 父母 对 他 期望 过高 。 
he has a lot of original ideas . 	他 有 很多 独到 的 见解 。 
i called him up yesterday . 	我 昨天 打电话 给 他 。 
she 's hiding the truth from us . 	她 不让 我们 知道 真相 。 
he arrived in time . 	他 及时 赶到 。 
for now , i will wait at the hotel . 	目前 我待 在 酒店 。 
do you have a car ? 	你 有 车 吗 ？ 
i am near the station . 	我 在 车站 附近 。 
do n't move , or i 'll shoot you . 	别动 ， 不然 我 就 开枪 射 你 。 
tom helped mary move the furniture . 	汤姆 帮 玛丽 移动 家具 。 
you 're not even paying attention . 	你 根本 没有 注意 。 
the situation has become hopeless . 	情况 变得 没有 希望 了 。 
let your uncle think about it . 	让 你 叔叔 想 一想 。 
her dream is to visit paris . 	她 的 梦想 是 参观 巴黎 。 
he 's in charge of the department . 	他 负责 这个 部门 。 
i have n't seen him for years . 	我 有些 年 没见 过 他 了 。 
freedom is the center of american democracy . 	美国 民主 的 中心思想 是 自由 。 
he got a loan from the bank . 	他 从 银行 得到 了 贷款 。 
he asked her seven times to marry him . 	他求 她 跟 他 结婚 七次 。 
it 's very easy to miss this kind of mistake . 	这种 错误 很 容易 被 人 忽视 。 
do n't let tom leave . 	别 让 汤姆 走 了 。 
did you find your contact l@@ en@@ ses ? 	你 找到 你 的 隐形眼镜 了 吗 ？ 
he has gone to britain . 	他 已经 去 了 英国 。 
we should abo@@ lish the death pen@@ al@@ ty . 	我们 应该 废除 死刑 。 
tom threw in the towel . 	汤姆 不干 了 。 
the telephone was invented by bell . 	电话 是 由 贝尔 发明 的 。 
my room faces the garden . 	我 的 房间 面向 花园 。 
i 'd like to have another cup of coffee . 	我 想 再 要 一杯 咖啡 。 
i 've no idea . 	我 一无所知 。 
tom refused to answer any questions . 	汤姆 拒绝 回答 任何 问题 。 
i knew what tom was doing . 	我 知道 汤姆 在 做 什么 。 
i do n't have any change . 	我 没 任何 零钱 。 
you dropped your handkerchief . 	你 的 手帕 掉 了 。 
tom is really handsome . 	汤姆 真帅 。 
you 're always busy . 	你 一直 忙 。 
ac@@ tion speaks louder than words , but not nearly as often . 	行胜于 言 ， 但 并 不是 所有 情况 都 是 这样 。 
according to my calcu@@ lation , she should be in india by now . 	根据 我 的 估计 ， 她 现在 应该 在 印度 了 。 
do you happen to know his name ? 	你 说不定 知道 他 的 名字 ？ 
i laughed at his joke . 	他 的 笑话 让 我 大笑 了 。 
we had bad weather yesterday . 	昨天 天气 很 糟 。 
mary is going to help us tomorrow . 	玛丽 明天 会帮 我们 。 
the risk is too great . 	风险 太大 。 
i ca n't even remember what tom looks like . 	我 甚至 不能 记 起来 汤姆 长 什么样 。 
has he met them today ? 	他 今天 见 他们 了 吗 ？ 
i was searched by the customs offi@@ c@@ ers at the airport . 	我 在 机场 被 海关 人员 搜查 。 
lots of itali@@ ans went to australia . 	许多 义 大利 人去 了 澳大利亚 。 
there 's no one in the room . 	没有 人 在 房间 里 。 
what 's your occu@@ pa@@ tion ? 	您 的 职业 是 什么 ？ 
the committee con@@ sist@@ s of four members . 	委员会 由 四个 成员 组成 。 
there are some eggs in the box . 	盒子 里 有 一些 蛋 。 
i did n't get the point of his speech . 	我 没有 抓到 他 演讲 的 重点 。 
there is a cottage be@@ yond the bridge . 	桥 对面 有 一间 小屋 。 
no man can serve two ma@@ sters . 	没有 人 可以 共 侍二主 。 
i need many books . 	我 需要 很多 书 。 
compare your answ@@ ers with the teacher 's . 	把 你 的 答案 和 老师 的 比较 一下 。 
`` when will you come back ? '' `` it all depends on the weather . '' 	“ 你 什么 时候 回来 ？ ” “ 这 都 要 看 天气 。 ” 
when can we eat ? 	我们 什么 时候 可以 吃 ？ 
we need to talk about that as soon as possible . 	我们 需要 尽早 谈论 那件 事 。 
he wrote down the telephone number . 	他 写下 这个 电话号码 了 。 
my boyfriend is a jour@@ na@@ list . 	我 男朋友 是 个 记者 。 
the capital of po@@ land is war@@ saw . 	波兰 的 首都 是 华沙 。 
tom does n't like to wear a watch . 	汤姆 不 喜欢 戴 手表 。 
she 's already sleeping . 	她 已经 睡下 了 。 
your manners are n't very good . 	你 的 举止 不是 很 好 。 
who was playing ? 	谁 在 玩 ？ 
he asked me whether i was busy . 	他 问 我 是否 很忙 ？ 
we did n't know which bus to take . 	我们 不 知道 要 搭 哪 一班 公车 。 
there 's a big fly on the ceiling . 	有 一只 大 苍蝇 在 天花板 上 。 
the pen is on the desk . 	笔在 桌上 。 
after supper , i washed the dishes . 	晚 饭后 我 洗 了 餐具 。 
drunk driving is a serious problem . 	酒驾 是 个 严重 的 问题 。 
some people questi@@ oned his honesty . 	有些 人 质疑 他 的 诚实 。 
he does n't have any friends to play with . 	他 没有 任何 朋友 玩 。 
i caused him a lot of trouble . 	我 给 他 带来 了 很多 麻烦 。 
let me think about it . 	让 我 想 一想 。 
excuse me for opening your letter by mistake . 	对不起 , 我 错开 了 你 的 信 。 
she st@@ ir@@ red her coffee with a tea@@ spoon . 	她 用 茶匙 搅 她 的 咖啡 。 
we will stay here until sunday . 	星期天 前 我们 将会 待 在 这里 。 
it 's too dark to play tennis now . 	现在 太暗 了 不能 打 网球 。 
you are free to go home . 	你 随时 可以 回家 。 
you 're too old to be doing this kind of thing . 	你老 得 做不了 这种 事 了 。 
i got on the train for london . 	我 登上 去 伦敦 的 火车 。 
the days are getting longer and longer . 	白天 变得 越来越 长 。 
you 'll need their help . 	你 会 需要 他们 的 帮助 。 
if you ca n't have children , you could always ado@@ pt . 	如果 你 不能 有 孩子 ， 你 总能 领养 。 
all men are equal under the law . 	法律 之前 人人 平等 。 
this is ice . 	这是 冰块 。 
what is it you want to know ? 	你 想 知道 什么 ？ 
it 's ama@@ zing . 	太 神奇 了 。 
he bought his daughter a dress . 	他 买 了 一件 洋装 给 他 女儿 。 
what 's your name ? 	您 叫 什么 名字 ？ 
we had a late lunch at two . 	我们 在 两点 钟 很 晚 才 吃 午餐 。 
cooking takes too much time . 	做饭 太费 时间 了 。 
do n't blame tom for what mary did . 	别为 玛丽 犯 的 错 责备 汤姆 。 
he could n't run very fast . 	他 无法 跑 得 非常 快 。 
i would like to improve my english pronunciation . 	我 想 改善 我 的 英语 发音 。 
she squ@@ e@@ e@@ zed the juice from many oranges . 	她 用 了 许多 柳橙来 榨汁 。 
how did you accomp@@ lish this ? 	你 怎么 完成 的 ？ 
it ca n't be true . 	那 不 可能 是 真的 。 
do you drink a lot of milk ? 	你 喝 很多 牛奶 吗 ？ 
what do you like to do in your free time ? 	您 空闲 时间 喜欢 做 什么 ？ 
these people hate all foreigners . 	这些 人 讨厌 所有 的 外国人 。 
he 's my new friend . 	他 是 我 新交 的 朋友 。 
you should read a lot of books while you 're young . 	应该 趁 年轻 多读 点书 。 
the accident happened near his home . 	事故 发生 在 他家 附近 。 
the flowers in the garden need to be water@@ ed . 	花园里 的 花 需要 浇水 。 
the pressure was tre@@ men@@ d@@ ous . 	压力 很 巨大 。 
some people felt that tom 's behavior was in@@ appro@@ priate . 	一部分 人 感觉 Tom 的 行为 举止 不太 合适 。 
when she was thir@@ teen , she ran away from home . 	她 十三岁 的 时候 离家 出走 了 。 
who told you the story ? 	谁 告诉 你 这个 故事 ？ 
all that i know is that he gave up the plan . 	我 所 知道 的 是 他 放弃 了 这个 计划 。 
kyoto is not as large as osaka . 	京都 不如 大阪 大 。 
what do you eat for breakfast ? 	你 早餐 吃 什么 ? 
you 're always late . 	你 总是 迟到 。 
he is a tall boy . 	他 是 一个 高大 的 男孩 。 
i do n't believe you . you 're always telling lies . 	我 不 相信 你 。 你 总是 说谎 。 
we woke up very early in order to see the sun@@ rise . 	我们 起得 很早 为了 看到 日出 。 
where do you want to go ? 	你 想 去 哪里 ? 
she sat next to me . 	她 坐在 我 旁边 。 
you have many books . 	您 有 很多 书 。 
something is better than nothing . 	聊胜于无 。 
there is a computer on the table . 	桌子 上 有 一台 电脑 。 
we ca n't let them do that . 	我们 不能 让 他们 那么 做 。 
he colle@@ cted bits of information . 	他 收集 了 一些 讯息 。 
if there was no sun , all the animals would be dead . 	如果 没有 太阳 ， 那 所有 生物 都 会 死 。 
who taught you how to dance ? 	谁 教 你 跳舞 的 ? 
if we do n't hurry , we 'll be late . 	再 不 快点 就 迟到 了 噢 。 
let 's hope you do n't need it . 	希望 你 用不着 它 。 
tom avoi@@ ds mary whenever possible . 	汤姆 尽量 避开 玛丽 。 
i want much more . 	我要 多 很多 。 
i plan to stay at home all day tomorrow . 	我 打算 明天 在 家里 待 一天 。 
they work together . 	他们 在 一起 工作 。 
please choose one person . 	请 选择 一个 人 。 
that dis@@ co@@ very was quite acci@@ den@@ tal . 	那个 发现 纯属 偶然 。 
he 's gone to nagoya on business . 	他 去 名古屋 出差 。 
he had his shirt on inside out . 	他 把 他 的 衬衫 穿 反 了 。 
i know that he was busy . 	我 知道 他 忙 。 
please close the door . 	请 关上门 。 
my father neither drinks nor smokes . 	我 爸爸 既 不 喝酒 也 不 抽烟 。 
i live too far away . 	我 住 得 太远 了 。 
a slip of the tongue is sometimes fa@@ tal to a politician . 	有时候 口误 对 政治家 来说 是 致命 的 。 
the library is on the 4@@ th floor . 	图书馆 在 四楼 。 
tell me about it ! 	跟 我 讲讲 那件 事 。 
you run . 	你 跑 。 
i know an english teacher who comes from canada . 	我 认识 一个 加拿大 来 的 英语 教师 。 
he looks young . 	他 看起来 很 年轻 。 
where does he want to go ? 	他 想 去 哪里 ? 
he 's a student at this college . 	他 是 这 所 大学 的 学生 。 
the value of the yen has so@@ ared . 	日元 的 价值 大幅 上升 。 
i know everybody here . 	我 认识 这里 的 每个 人 。 
my room is a pi@@ g@@ sty . 	我 房间 是 个 猪 窝 。 
call security ! 	叫 保安 来 ！ 
she was frequently late for school . 	她 经常 上学 迟到 。 
i felt a drop of rain on my head . 	我 感觉 有 滴雨落 在 头上 。 
sometimes you get lucky . 	你 有时候 真 走运 。 
the room sme@@ lled of to@@ bac@@ co . 	房里 闻 起来 有股 烟味 。 
there is a bag on the desk . 	书桌 上 有 一个包 。 
we do n't live in boston . 	我们 不住 在 波士顿 。 
i know what it 's like to lose someone . 	我 知道 这 看起来 像是 失去 了 某人 。 
i 'm no qui@@ tter . 	我 不 轻易 放弃 。 
please stay here till i get back . 	请待 在 这里 直到 我 回来 。 
i wish i could talk to you . 	我 希望 能 与 你 谈话 。 
please translate this sentence into japanese . 	请 把 这句 话 翻译 成 日文 。 
do you have a driver 's license ? 	你 有 驾驶 执照 吗 ？ 
i go by the nick@@ name `` i@@ tch . '' 	我用 我 的 暱 称 " Itch " 。 
this diamond is not real . 	这颗 钻石 不是 真的 。 
he often eats fish for dinner . 	他 晚饭 经常 吃 鱼 。 
no one will bother you here . 	这里 没人会 打扰 你 。 
are you doing what you think is right ? 	你 在 做 你 觉得 对 的 事 吗 ? 
tom does n't know how to have fun . 	汤姆 不 知道 怎样 玩得 开心 。 
i do n't like anything . 	我 什么 都 不 喜欢 。 
i 'm glad i could help you . 	能够 出 一份 力太好 了 。 
i got something nice for you . 	我 给 你 个 好 东西 。 
it has n't been easy . 	它 不 容易 。 
that 's so perfect . 	那 是 完美 的 。 
this may take a while . 	这要 花 时间 。 
i did n't need to paint the fence . 	我 不 需要 粉刷 围墙 。 
my father insisted on our waiting for the train . 	我 的 父亲 坚持 要 我们 等 火车 。 
i do n't know if tom can help us . 	我 不 知道 汤姆 能 不能 幚 我们 。 
they decided to get married next month . 	他们 决定 在 下个 月 结婚 。 
how did you come by this money ? 	用 这些 钱 你 怎么 来 的 ? 
we know so little about you . 	我们 对 你 知道 得 不 多 。 
would you like to leave a message ? 	你 要 留言 吗 ？ 
how many people are there in your family ? 	你家 有 几口 人 ？ 
he got tired of reading . 	他 厌倦 了 读书 。 
when is it convenient for you ? 	你 什么 时候 方便 ？ 
why were you there ? 	你 为什么 在 那里 ? 
it seems that the only time he is n't eating is when he 's sleeping . 	看来 他 只有 在 睡觉 时 不吃 东西 。 
i hope you 'll get well soon . 	我 希望 你 很快 就 会 好 。 
she looks a lot like her mother . 	她 非常 像 她 的 母亲 。 
i hope i will have a chance to see you next time i 'm in new york . 	希望 下次 我 在 纽约 还 可以 有 机会 见到 你 。 
most of all , i hate wearing socks . 	我 最 讨厌 穿船 袜 了 。 
the weather turned better . 	天气 转好 了 。 
my house is big . 	我家 很大 。 
i 'll attend the next meeting . 	我会 参加 下次 的 会议 。 
he was ex@@ p@@ el@@ led from school . 	他 被 逐出 了 学校 。 
was there anyone in the room ? 	房间 里 有人 吗 ？ 
you 're an idiot . 	你 个 呆 瓜 ！ 
what is the name of that bird ? 	那 只 鸟 叫 什么 名字 ？ 
he seems not to be aware of the con@@ fli@@ ct between my father and me . 	他 似乎 不 知道 我 父亲 和 我 之间 的 纠葛 。 
do you like strawberries ? 	你 喜欢 草莓 吗 ？ 
he did not get up early . 	他 没有 早起 。 
i 'm very happy to see you . 	我 很 高兴 见到 你 。 
the storm ab@@ ated . 	风暴 减弱 了 。 
may i open the box ? 	我能 打开 盒子 吗 ? 
she de@@ cor@@ ated her room with roses . 	她 用 玫瑰花 装饰 了 她 的 房间 。 
i majored in american literature at college . 	我 在 大学 主修 美国 文学 。 
suddenly , it started to rain very hard . 	突然 就 下 起 了 大雨 。 
he has been in hokkaido before . 	他 以前 曾 在 北海道 。 
she played a tune on the piano . 	她 在 钢琴 上弹 了 一首 曲子 。 
that 's not fair . 	那 是 不 公平 的 。 
be realistic ! 	现实 点 ！ 
let 's find out who sent this to us . 	让 我们 查查 谁 送给 我们 这个 。 
a man is responsible for his dee@@ ds . 	一个 人要 为 他 的 行为 负责 。 
time is the most pre@@ cious thing in the world . 	时间 是 世界 上 最 宝贵 的 东西 。 
i was so cold . 	我 很 冷 。 
bring me a bucket of water . 	给 我 一桶 水 。 
tom can swim faster than anyone else i know . 	汤姆 是 我 认识 的 人 当中 游泳 最快 的 。 
i 'm not sure . 	我 不 确定 。 
i do n't know when he 's coming . 	不 知道 他 什么 时候 来 。 
please feed the dog every day . 	请 每天 喂 一下 狗 。 
i want a qu@@ art of milk . 	我要 一夸脱 的 牛奶 。 
no words can relie@@ ve her deep sor@@ row . 	没有 什么 话语 能 减轻 她 深深 的 悲伤 。 
b@@ ears can climb trees . 	熊会 爬树 。 
i did n't mean that . 	我 没有 那个 意思 。 
tom does n't like cheese . 	汤姆 不 喜欢 乳酪 。 
i 'll give you anything but this . 	除了 这个 之外 我会 给 你 任何 东西 。 
i lost my way in the woods . 	我 在 树林 里 迷路 了 。 
why did you begin without me ? 	为什么 你 不 等等 我 就 开始 了 ？ 
her father is japanese . 	她 父亲 是 日本 人 。 
they 're not afraid of hard work . 	他们 不怕 艰苦 的 工作 。 
he did n't say a word to me all day . 	他 一天 也 没 跟 我 说 一句 话 。 
attack is the best form of de@@ f@@ en@@ se . 	进攻 是 最好 的 防御 。 
please keep it secret . 	请 保守 秘密 。 
keep in mind that you must die . 	你 要 想到 你 必须 死 。 
i think it 's very difficult . 	我 认为 它 很 难 。 
it 's no use arguing about it . 	争论 是 它 是 没有 用 的 。 
she says she will call you later . 	她 说 她 晚 一点 会 打电话 给 你 。 
even expert dri@@ vers can make mistakes . 	再 怎么 经验 老到 的 司机 都 会 出错 。 
there are many parks in london . 	伦敦 有 很多 公园 。 
how unfortun@@ ate ! 	可怜 ! 
what time do you usually get up ? 	你 通常 什么 时候 起床 ？ 
were you tired last night ? 	昨晚 你 累 了 吗 ？ 
you should 've never interf@@ ered . 	你 从来不 该 干涉 。 
tom 's life was changed forever . 	汤姆 的 生活 被 彻底 改变 了 。 
they were busy working for social re@@ for@@ ms . 	他们 忙于 社会 改革 。 
go on home . 	回家 吧 。 
tom is reading an ess@@ ay . 	汤姆 在读 一篇 短文 。 
let 's visit some tem@@ pl@@ es tomorrow . 	让 我们 明天 参观 一些 寺庙 。 
his ab@@ s@@ ence gave birth to all sor@@ ts of ru@@ mor@@ s . 	他 的 缺席 导致 了 各种 谣言 的 产生 。 
as more paper money came into use , the value fell . 	当 更 多 的 纸币 投入 使用 ， 价格 就 下跌 了 。 
the train arrived on time . 	火车 准时 到 了 。 
tom is a vie@@ t@@ n@@ am veter@@ an . 	汤姆 是 一个 越军 退役 军人 。 
my first day in the university was rather boring . 	我 大学 里 的 第一天 相当 没意思 。 
he got off the bus . 	他 下 了 公车 。 
come to my house this afternoon . 	今天 下午 到 我家 来 一趟 。 
you are working too hard . take it easy for a while . 	你 工作 得 太 辛苦 了 。 放 轻松 一下 。 
the program starts at nine o'clock . 	这个 节目 九点 开始 。 
i do n't feel like eating anything today . 	我 今天 不想 吃 东西 。 
this is my bicycle . 	这 是 我 的 自行车 。 
i believe in exer@@ ci@@ sing regularly . 	我 相信 规律 的 运动 。 
i 'm hoping that that 'll happen . 	我 希望 那会 发生 。 
industry as we know it today did n't exist in those days . 	我们 今天 所 认识 的 工业 在 那个 时代 不 存在 。 
this is smaller than that . 	这个 比 那个 更 小 。 
lots of people in japan are in@@ different to politics . 	很多 日本 人 对 政治 冷淡 。 
she has already left the office . 	她 已经 离开 了 办公室 。 
this is quite good . 	这可真 好 。 
there are many ways to improve one 's life . 	有 很多 的 方法 可以 改善 人 的 一生 。 
i do n't have a car . 	我 没有 汽车 。 
i 'm sorry to hear it . 	我 听 了 感到 抱歉 。 
i 'm looking for my keys . have you seen them ? 	我 正在 找 钥匙 ， 你 看见 了 吗 ？ 
i am suffering from a bad cold . 	我 患上 了 重感冒 。 
this table is heavy . 	这张 桌子 很重 。 
the problem is who is going to tell him the truth . 	问题 是 谁 要 告诉 他 真相 。 
you talk too much . 	你 说 太 多 了 。 
many people were waiting in line . 	许多 人 在 排队 等候 。 
how many boys are there in this class ? 	这个 班有 多少 男生 ？ 
it was not very cold yesterday . 	昨天 不是 很 冷 。 
i do n't sing very well . 	我 唱歌 不太好 。 
it was extremely scary . 	这太 可怕 了 。 
what 's today 's date ? 	今天 几号 ？ 
i like jazz music . 	我 喜欢 爵士乐 。 
i once wanted to be an a@@ stro@@ physi@@ ci@@ st . 	我 曾经 想过 当个 太空 物理学家 。 
this novel is boring . 	这本 小说 很 无聊 。 
nee@@ d@@ less to say , f@@ unda@@ mental human ri@@ ghts should be respe@@ cted . 	无须 多言 ， 基本 人权 应当 被 尊重 。 
it cost him 50 dollars to rent a car in hawaii . 	他花 了 50 美元 在 夏威夷 租 了 一辆 汽车 。 
the door is locked at nine o'clock . 	这个 门 在 九点 钟 的 时候 是 锁 著 的 。 。 
i may be un@@ soci@@ able , but it does n't mean i do n't talk to people . 	我 或许 不 善于 社交 , 但 这 并 不 意味 我 不 和 别人 交谈 。 
his new car is wonderful . 	他 的 新车 很棒 。 
tom is worried for his safety . 	汤姆 担心 他 的 安全 。 
i do n't have the slightest intention of reti@@ ring . 	我 没有 一点 退休 的 念头 。 
i was at home . 	我 刚才 在家 。 
she did nothing but cry all the while . 	她 一直 哭哭啼啼 。 
i lost my money . 	我 丢 了 我 的 钱 。 
this book is for students whose native language is not japanese . 	这 本书 是 给 母语 不是 日语 的 学生 的 。 
you ought to have come here earlier . 	你 应该 早点 来 的 。 
let me see that . 	让 我 看看 。 
this is the worst hotel in town . 	这是 城里 最 糟糕 的 旅馆 。 
tom is awfully sick . 	汤姆 非常 虚弱 。 
just take my word for it . 	请 相信 我 的话 。 
i have n't seen tom lately . 	我 最近 没 看到 汤姆 。 
tom wanted something else . 	汤姆 想要 别的 东西 。 
i want this camera . 	我要 这台 相机 。 
have you been fired ? 	你 曾经 被 开除 过 吗 ? 
he already knew about it . 	他 已经 意识 到 它 了 。 
he earned his living as a teacher . 	他 以 当 老师 为生 。 
i do n't know if today is tuesday or wednesday . 	我 不 知道 今天 是 星期二 还是 星期三 。 
she has blue eyes . 	她 有 蓝色 的 眼睛 。 
it 's just your imagination . 	那 只是 你 的 想象 。 
no one was late . 	没有 人 迟到 。 
how are you , tom ? 	你好 吗 ， 汤姆 ？ 
why should i hire tom ? 	为什么 我要 雇佣 Tom ？ 
she spent a good deal of money on her vacation . 	她 休假 期间 花 了 一 大笔 钱 。 
it 's a dead end . 	这 是 个 死胡同 。 
she left the hospital an hour ago . 	她 一 小时 前 离开 了 医院 。 
let 's sing the song in english . 	让 我们 唱 英文 歌曲 。 
i 'm sure we 'll find a solution . 	我 确信 我们 会 找到 解决办法 的 。 
that responsibility is a bur@@ den to him . 	那个 责任 对 他 是 个 负担 。 
he was drowned . 	他 被 淹死 了 。 
he wi@@ ped the sw@@ eat from his face . 	他 擦 去 了 脸上 的 汗水 。 
she suggested to me that i call off the meeting . 	她 建议 我 取消 会议 。 
tom is a student . 	汤姆 是 个 学生 。 
our car broke down last night . 	我们 的 昨晚 车 抛锚 了 。 
i think this book is worth reading . 	我 觉得 这 本书 值得 一读 。 
i 'll be back in a j@@ i@@ f@@ fy . 	我 马上 就 回来 。 
what is your house like ? 	你 的 房子 如何 ？ 
she waited for hours and hours . 	她 等 了 好几个 小时 。 
do n't write in red ink . 	别用 红 墨水 写 。 
i want something to read . 	我 要些 读 的 东西 。 
some of them seem to be too difficult . 	其中 一些 似乎 太难 了 。 
do you have anything to eat ? 	你 有 东西 吃 吗 ？ 
i 'll call you as soon as i can . 	我会 尽快 给 你 打电话 的 。 
thank you for agre@@ e@@ ing to meet with us . 	谢谢 你 答应 来 见 我 。 
the bu@@ tter@@ fly flew away . 	蝴蝶 飞走 了 。 
can i speak to the head nurse ? 	我能 跟 护士长 说话 吗 ? 
did you get my letter ? 	你 收到 了 我 发 的 邮件 了 吗 ？ 
this is the house where he lived . 	这 是 他 住 的 房子 。 
you 'd better wait until the police come . 	你 最好 等到 警察 前来 。 
how long will you be staying ? 	你 会 待 多长 时间 ？ 
he was n't able to attend the party . 	他 无法 参加 这个 派对 。 
he has written a letter . 	他 写 了 一 封信 。 
no student went to the party . 	没有 学生 去 参加 派对 。 
what you see is what you get . 	你 看到 什么 拿 什么 。 
my wish is to become a teacher . 	我 的 愿望 是 成为 一个 老师 。 
my father did n't eat much fruit . 	我 父亲 没有 吃 很多 的 水果 。 
i was n't quite sure what to say . 	我 不 太 确定 要说 什么 。 
i know how old you are . 	我 知道 你 多 大 了 。 
they all envi@@ ed my new car . 	他们 都 羡慕 我 的 新车 。 
i know that you 're right . 	我 知道 你 是 对 的 。 
are you going to school tomorrow ? 	你 明天 要 去 上学 吗 ？ 
i gazed at the sea for hours . 	我望 著海 好几个 小时 。 
i was brought up in the country . 	我 在 乡下 被 抚养 长大 。 
gold is far heavier than water . 	金子 比水 重得 多 。 
my mother speaks french better than my father speaks english , so they usually speak to each other in french . 	我 母亲 的 法语 比 我 父亲 的 英语 要 好 ， 所以 他们 通常 用 法语 交流 。 
he wears glasses . 	他 戴 眼镜 。 
i refuse to answer your question . 	我 拒绝 回答 你 的 问题 。 
what do you want me to do , tom ? 	你 想 让 我 做 甚么 ， 汤姆 ？ 
the school is on top of the hill . 	学校 在 山丘 顶上 。 
wherever you go , i will follow . 	无论 你 到 哪里 ， 我 都 会 跟 著 你 。 
put some salt into the bo@@ iling water . 	放点 盐 到 滚水 里 。 
we did n't see anybody . 	我们 谁 也 没 看见 。 
i lost my way in the forest . 	我 在 树林 里 迷路 了 。 
she 's as busy as tom . 	她 和 汤姆 一样 忙 。 
i study chinese every day . 	我 每天 读 中文 。 
i love parties . 	我 爱 派对 。 
we do n't think so . 	我们 不 这样 认为 。 
someone has brought us some grapes . 	有人 带 了 一些 葡萄 给 我们 。 
which bed do you want to use ? 	你 想 睡 哪 张床 ? 
i warned him about the danger . 	我 跟 他 说 过 很 危险 的 。 
he 's afraid of the dog . 	他 怕 那 只 狗 。 
money is the roo@@ t of all evi@@ l . 	金钱 是 一切 罪恶 之源 。 
exercise is good for your health . 	做 运动 有利于 健康 。 
as far as the teacher was concerned , she was a jo@@ y to teach . 	就 一个 老师 而言 ， 她 教书 教得 很 快乐 。 
my mother was an alco@@ holi@@ c . 	我 母亲 是 个 酒鬼 。 
dry wood burns well . 	干柴 烧得旺 。 
i heard him go down the stairs . 	我 听见 了 他 下楼 。 
it is dangerous to drive so fast . 	车开 得 这么 快 很 危险 。 
i am tired of my work . 	我 厌倦 了 我 的 工作 。 
do you know where i live ? 	你 知道 我 住 哪 吗 ？ 
i did n't play tennis yesterday . 	我 昨天 没有 打 网球 。 
i 'm not a child , but sometimes you talk to me as if i were a child . 	我 不是 小孩子 ， 但 有时 你 跟 我 说话 就 好像 我 是 小孩子 一样 。 
tom bought a mo@@ bi@@ le phone . 	汤姆 买 了 个 手机 。 
the ceremony will take place tomorrow . 	明天 举行 典礼 。 
i 'm sen@@ ding you a birthday present by air@@ mail . 	我 寄 给 你 一个 航空 邮件 生日 礼物 。 
hurry up , and you will be in time for the bus . 	快点 ， 你 就 能 准时 搭上 公交车 了 。 
i 've been learning to drive . 	我 一直 在 学 开车 。 
did you buy a nice bicycle ? 	你 买 了 辆 好 自行车 吗 ？ 
he sub@@ sti@@ tu@@ ted for his father . 	子承 父业 。 
this drink is on the house . 	这种 饮料 是 免费 招待 的 。 
we arrived at the office on time . 	我们 准时 到达 了 办公室 。 
could you please pass me the pepper ? 	能 把 胡椒 递给 我 吗 ？ 
do you think tom was satisfied ? 	你 认为 汤姆 满意 了 吗 ？ 
my back still hurts . 	我 的 背 还 在 痛 。 
i did everything by myself . 	我 全靠 自己 。 
she and i have nothing in common . 	我 和 她 没有 共同 之处 。 
i owe you ten dollars . 	我 欠 你 10 美元 。 
mastering a foreign language calls for patience . 	精通 一种 外语 需要 耐心 。 
her feelings are easily hurt . 	她 很 容易 受到 感情 上 的 伤害 。 
i admire you for your courage . 	我 佩服 你 的 勇气 。 
do you live with your parents ? 	你 和 你 的 父母 同住 吗 ？ 
where is tom 's classroom ? 	汤姆 的 教室 在 哪里 ？ 
i succeeded in getting what i wanted . 	我 赢得 了 我 想要 的 。 
nobody likes war . 	没有 人 喜欢 战争 。 
everything depends upon your decision . 	所有 事 都 取决于 你 的 决定 。 
i was invited to their wedding . 	我 被 邀请 参加 他们 的 婚礼 。 
we 're having dinner . 	我们 在 吃 晚餐 。 
the car is waiting at the gate . 	车 在 门口 等 著 。 
i found the key under@@ nea@@ th the mat . 	我 在 擦 鞋垫 下面 发现 了 这 把 钥匙 。 
let 's clear up this problem . 	把 问题 澄清 一下 。 
there is no water . 	没有 水 。 
my father was no less affe@@ cti@@ on@@ ate and ten@@ der to me than my mother was . 	我 爸爸 对 我 的 爱 和 照顾 不比 我 妈妈 少 。 
he p@@ in@@ ched and scra@@ ped for many years to save money . 	为了 存钱 他 省吃俭用 了 许多年 。 
i do n't mind hot weather . 	我 不在乎 炎热 的 天气 。 
look back ! 	回头 看 ！ 
why do you want to be a nurse ? 	你 为什么 想 成为 护士 呢 ？ 
who 's in charge of this section ? 	谁 负责 这个 部门 ？ 
i do n't think she takes after her mother . 	我 不 觉得 她 像 她 妈妈 。 
