▁The ▁plane ▁takes ▁off ▁in ▁ten ▁minutes .	▁ 飞机 十分钟 后 起 飞 。
▁B et ween ▁you ▁and ▁me , ▁Tom ' s ▁idea ▁doesn ' t ▁appe al ▁to ▁me ▁very ▁much .	▁汤姆的 主意 我不 太 感兴趣 , 这个 我们 之间 说 说 就 好 。
▁Could ▁you ▁send ▁me ▁a ▁bro ch ure ?	▁你能 寄 宣 传 册 给我 吗 ?
▁Do ▁you ▁think ▁Tom ▁is ▁having ▁fun ?	▁你认为 汤姆 玩得 高兴 吗 ?
▁You ▁can ▁see ▁the ▁r oof ▁of ▁the ▁house ▁from ▁there .	▁你能 从 那里 看到 房子 的 顶 。
▁Thank ▁you ▁for ▁inv it ing ▁me .	▁谢谢你 邀请 我 。
▁I ▁was ▁very ▁impress ed ▁by ▁his ▁story .	▁我被 他的 故事 感 染 了 。
▁You ▁should ▁study ▁harder .	▁你应该 更 努力学习 。
▁I ▁don ' t ▁feel ▁like ▁eating ▁anything .	▁我不想 吃 任何东西 。
▁P op c or n ▁is ▁my ▁favorite ▁sn ack .	▁ 爆 米 花 是我最喜欢的 零 食 。
▁She ▁is ▁not ▁as ▁patient ▁as ▁you .	▁她 没 像 你 那样 有 耐心 。
▁It ' s ▁con ven ient ▁for ▁me ▁to ▁see ▁you ▁at ▁ten ▁tonight .	▁我 今晚 10 点 见你 比较 方便 。
▁I ▁haven ' t ▁done ▁that ▁since ▁high ▁school .	▁ 高中 毕业 之后 我就 没 那样做 过了 。
▁I ▁didn ' t ▁have ▁time ▁to ▁watch ▁TV ▁yesterday .	▁我昨天 没 时间 看电视 。
▁Sunday ▁is ▁not ▁a ▁work day ▁for ▁me .	▁我在 星期日 不 工作 。
▁Nobody ▁likes ▁being ▁laughed ▁at .	▁没有人 喜欢 被 人 嘲笑 。
▁How ▁much ▁is ▁it ?	▁ 多少钱 ?
▁We ▁have ▁a ▁war r ant ▁to ▁se ar ch ▁your ▁ap artment .	▁我们有 权 搜 查 你的 公 寓 。
▁Do ▁you ▁know ▁him ?	▁你 认识 他 吗 ?
▁You ▁should ▁read ▁many ▁books ▁when ▁you ▁are ▁young .	▁当你 年轻 的时候 , ▁你应该 多 读 点儿 书 。
▁What ▁is ▁the ▁name ▁of ▁this ▁river ?	▁这条 河 叫什么名字 ?
▁All ▁lawy ers ▁are ▁li ars .	▁ 律师 都是 骗 子 。
▁A pp les ▁were ▁ser ved ▁as ▁the ▁d ess ert .	▁ 苹果 被 用来 当 作 甜 点 。
▁She ▁doesn ' t ▁want ▁to ▁talk ▁about ▁it .	▁她 不想 提 了 。
▁Any body ▁would ▁be ▁better ▁than ▁nobody .	▁不管 是谁 总 比 没人 好 。
▁Every ▁one ▁of ▁her ▁songs ▁was ▁a ▁hit .	▁她的 每 首歌 都 长 期 备 受欢迎 。
▁She ▁and ▁I ▁have ▁nothing ▁in ▁common .	▁我和 她 没有 共 同 之 处 。
▁I ▁am ▁near ▁the ▁station .	▁我在 车站 附近 。
▁No ▁student ▁is ▁allowed ▁to ▁enter ▁the ▁room .	▁ 学生 不 准 进入 这个房间 。
▁After ▁supper , ▁I ▁washed ▁the ▁dishes .	▁晚饭后 我 洗 了 碗 碟 。
▁Somebody ' s ▁got ▁to ▁do ▁something .	▁ 得 有人 做 点 什么 。
▁I ▁have ▁a ▁bad ▁to ot ha c he .	▁我 牙 痛 得 厉害 。
▁I ' m ▁in ▁a ▁bad ▁m ood ▁today .	▁我今天 的 心 情 不好 。
▁What ▁do ▁you ▁think ▁of ▁that ?	▁你认为 如何 ?
▁I ▁picked ▁up ▁a ▁pretty ▁she ll ▁at ▁the ▁se as ide .	▁我在 海 边 捡 了个 漂亮 贝 壳 。
▁How ▁long ▁is ▁this ▁vis a ▁good ▁for ?	▁这个 签 证 的 有 效 期 限 是 多久 ?
▁How ▁much ▁does ▁it ▁cost ?	▁ 多少钱 ?
▁He ▁ate ▁a ▁box ▁of ▁ch ocol ates .	▁他 吃 了一 盒 巧克力 。
▁Th ousand s ▁of ▁can d les ▁ill um in ated ▁the ▁church ▁during ▁the ▁ce rem ony .	▁数 以 千 计 的 蜡 烛 点 亮 了 仪 式 中的 教堂 。
▁He ▁called ▁me ▁up ▁almost ▁every ▁day .	▁他 几乎 每天 打电话 给我 。
▁He ▁was ▁very ▁good ▁at ▁playing ▁tennis .	▁他 网球 打 得很好 。
▁I ▁cannot ▁afford ▁to ▁buy ▁a ▁car .	▁我买 不起 一 辆车 。
▁He ▁made ▁his ▁son ▁a ▁chair .	▁他 做了一 把 椅子 给他 儿子 。
▁I ▁think ▁it ' s ▁better ▁for ▁us ▁to ▁ad op t ▁his ▁plan .	▁我认为 采 用 他的 计划 对我们 比较 好 。
▁Tom ▁started ▁d ating ▁Mary ▁three ▁months ▁ago .	▁汤姆 三个月 前 开始 和玛丽 约会 。
▁All ▁their ▁sec rets ▁have ▁been ▁re ve al ed .	▁他们 所有的 秘密 都 已经 被 揭 晓 了 。
▁It ▁is ▁raining .	▁ 下雨了 。
▁We ▁can ' t ▁just ▁fire ▁Tom .	▁我们不能 仅 仅 就 这样 炒 了 汤姆
▁I ▁need ▁help .	▁我需要 帮助 。
▁How ▁can ▁you ▁afford ▁a ▁place ▁like ▁this ?	▁我们 怎么 付 得 起 这种 地方 的钱 ?
▁The ▁wind ▁is ▁bl ow ing ▁from ▁the ▁n ort h .	▁风 从 北 边 来 。
▁I ▁had ▁a ▁good ▁sleep ▁last ▁night .	▁我昨晚 睡 得很好 。
▁How ▁are ▁things ▁at ▁work ?	▁ 工作 怎么样 ?
▁Let ▁me ▁give ▁you ▁a ▁lift ▁as ▁far ▁as ▁the ▁station .	▁让我 送 你 到车站 吧 。
▁It ▁may ▁never ▁happen .	▁它 可能 从 没 发生 过 。
▁I ▁couldn ' t ▁make ▁myself ▁understood .	▁我无法 让 别人 了解 我的 意思 。
▁Come ▁home .	▁ 回家 吧 。
▁What ▁are ▁you ▁looking ▁at ?	▁你在看什么 ?
▁You ▁ch ose ▁this ▁job ▁yourself , ▁right ?	▁你 自己 选择 了这 份工作 , 是吗 ?
▁He ▁is ▁the ▁father ▁of ▁two ▁children .	▁他是 两个 孩子 的 父亲 。
▁That ▁house ▁is ▁very ▁small .	▁这 房子 非常 小 。
▁Let ' s ▁take ▁turn s ▁r ow ing ▁the ▁boat .	▁让我们 轮 流 划 船 。
▁Please ▁keep ▁an ▁eye ▁on ▁my ▁suitcase .	▁请 留 神 看著 我的 手提 箱 。
▁The ▁boy ▁doesn ' t ▁know ▁how ▁to ▁beha ve .	▁这个男孩 不懂 礼貌 。
▁I ' m ▁sorry , ▁but ▁I ▁really ▁have ▁to ▁go .	▁我很抱歉 , 但我 必须 走了 。
▁Take ▁whatever ▁you ▁like .	▁你喜欢 什么 就 拿 吧 。
▁I ▁won dered ▁if ▁her ▁story ▁was ▁true .	▁我想知道 她的 故事 是否 是真的 。
▁We ▁have ▁many ▁rain y ▁days ▁in ▁J une .	▁ 六 月 下了 很多 天 的 雨 。
▁The ▁area ▁of ▁the ▁factory ▁is ▁1 ,000 ▁s qu are ▁met ers .	▁ 工厂 的 面 积 是 1 000 平 方 米 。
▁Thank ▁you ▁for ▁your ▁transl ation .	▁谢谢 你的 翻译 。
▁I ▁att em pt ed ▁to ▁solve ▁the ▁problem .	▁我 试图 解决这个问题 。
▁I ▁want ▁to ▁buy ▁a ▁pair ▁of ▁p ants .	▁我想 买 条 裤子 。
▁What ' s ▁she ▁doing ?	▁她在 做什么 ?
▁We ▁sometimes ▁swim ▁in ▁the ▁lake .	▁我们 偶尔 在 湖 里游泳 。
▁I ▁have ▁almost ▁no ▁money ▁with ▁me .	▁我 身上 几乎 没有 钱 。
▁You ▁may ▁be ▁late ▁for ▁school .	▁您 上学 可能会 迟到 。
▁I ' ve ▁just ▁started ▁playing ▁tennis .	▁我刚 开始 打网球 。
▁This ▁is ▁just ▁a ▁h y p ot hes is .	▁这只 是个 假 设 。
▁Can ▁you ▁do ▁some ▁shopping ▁for ▁me ?	▁你能帮我 买 些 东西 吗 ?
▁Give ▁Tom ▁back ▁his ▁money .	▁把 汤姆的 钱 还 给他 。
▁Some ▁people ▁are ▁difficult ▁to ▁please .	▁有些人 很难 取 悦 。
▁He ▁has ▁a ▁large ▁family ▁to ▁support .	▁他要 抚 养 一 大 家人 。
▁I ▁was ▁the ▁second ▁to ▁last ▁person ▁to ▁hear ▁the ▁bad ▁news .	▁我是 倒 数 第二 个 得 知 这个 坏 消息 的 。
▁What ▁do ▁you ▁plan ▁to ▁major ▁in ▁at ▁college ?	▁你 计划 去 大学 后 主修 什么吗 ?
▁I ▁returned ▁the ▁knife ▁which ▁I ▁had ▁borrowed .	▁我把 我 借 来的 刀 还 了 。
▁She ▁spoke ▁sc ar ce ly ▁a ▁word ▁of ▁English .	▁她 几乎 不 说英语 。
▁We ▁need ▁to ▁leave .	▁我们必须 走了 。
▁Mary ▁looks ▁like ▁her ▁mother .	▁玛丽 长 得像 她 妈妈 。
▁There ▁are ▁sub tle ▁differen ces ▁between ▁the ▁two ▁pictures .	▁这 两 张 图片 之间 有 细 致 的 差 异 。
▁I ▁waste ▁a ▁lot ▁of ▁time ▁day d ream ing .	▁我 浪费 了很多 时间 作 白 日 梦 。
▁Why ▁don ' t ▁you ▁eat ▁vegetables ?	▁为什么 你不 吃 蔬菜 ?
▁Were ▁you ▁a ▁sold ier ?	▁你是 士兵 吗 ?
▁I ' m ▁fine ▁now .	▁已经 没 事了 。
▁He ▁is ▁not ▁ashamed ▁of ▁being ▁poor .	▁他不 因 贫 穷 而 感到 羞 愧 。
▁He ▁said ▁nothing , ▁which ▁made ▁her ▁angry .	▁他 什么 也没 说 , 这 让她 很 生气 。
▁Let ' s ▁div ide ▁this ▁money ▁between ▁you ▁and ▁me .	▁这 钱 你 和我 分 了 吧 。
▁These ▁p ants ▁fit ▁me ▁well .	▁我 穿 这条 裤子 很 合 身 。
▁They ▁got ▁to ▁the ▁hotel ▁after ▁dark .	▁天 暗 后 他们 到了 酒店 。
▁Be ▁respect ful ▁to ▁your ▁sup eri or s , ▁if ▁you ▁have ▁any .	▁如果你 有 上 司 的话 , 学会 尊 敬 他 ( 她 ) 。
▁Can ▁you ▁use ▁a ▁computer ?	▁您 会 使用 计 算 机 吗 ?
▁Don ' t ▁make ▁fun ▁of ▁people .	▁不要 取 笑 人 。
▁I ▁want ▁you ▁to ▁sleep ▁on ▁it .	▁我想要 你 睡 在 它 上 边 。
▁I ▁can ' t ▁put ▁up ▁with ▁it .	▁我无法 忍受 它了 。
▁I ▁asked ▁him ▁many ▁questions ▁about ▁ec olog y .	▁我问 了他 许多 关于 生 态 环 境 的问题 。
▁He ▁bought ▁her ▁a ▁sweater .	▁他 买了一 件 毛衣 给她 。
▁R ome ▁wasn ' t ▁built ▁in ▁a ▁day .	▁ 罗马 不是 一天 建 成的 。
▁Un be l ie v able !	▁ 难以 置 信 !
▁There ▁is ▁little ▁chance ▁of ▁his ▁win ning .	▁他 赢 的 机会 极 小 。
▁This ▁book ' s ▁new .	▁这本书 是 新的 。
▁I ▁wish ▁he ▁had ▁attend ed ▁the ▁meeting .	▁要 是他 有 参加 这 场 会议 就好了 。
▁I ▁have ▁three ▁million ▁dollars .	▁我有 三 百 万 美 圆 。
▁It ▁belong s ▁to ▁my ▁brother .	▁它 属于 我 兄弟 。
▁I ▁wasn ' t ▁busy ▁last ▁week .	▁我上 周 不 忙 。
▁Tom ▁will ▁never ▁willing ly ▁go ▁there ▁by ▁himself .	▁汤姆 绝 不会 愿意 独自 去那里 。
▁Can ▁we ▁ro ll er - s k ate ▁in ▁this ▁park ?	▁我们 可以 在这个 公园里 玩 四 轮 溜 冰 吗 ?
▁He ▁had ▁his ▁socks ▁on ▁inside ▁out .	▁他把他的 袜子 穿 反 了 。
▁We ▁accept ▁all ▁major ▁c red it ▁cards .	▁我们 接受 所有 主 要 的 信用卡 。
▁I ▁thought ▁I ▁was ▁dream ing .	▁我还 以 为我 在 做 梦 呢 。
▁Do ▁you ▁study ▁every ▁day ?	▁你 每天都 学习 吗 ?
▁How ▁could ▁I ▁be ▁a ▁rob ot ? ▁R ob ots ▁can ' t ▁dream .	▁我 怎么 可能 是 机器 人 呢 ? 机器 人 不会 做 梦 。
▁Someone ▁is ▁knock ing ▁on ▁the ▁door .	▁不 知 是谁 在 敲门 。
▁What ▁are ▁you ▁doing ▁here ?	▁你 在这里 做什么 ?
▁Tom ▁tried ▁to ▁control ▁his ▁em ot ions .	▁汤姆 试着 控制 他的 情 绪 。
▁Why ▁don ' t ▁we ▁order ▁pizza ?	▁为什么 不 订 些 批 萨 呢 ?
▁Tom ▁sat ▁b es ide ▁Mary .	▁汤姆 坐在 玛丽 旁边 。
▁I ▁am ▁very ▁busy ▁these ▁days .	▁我 最近 很忙 。
▁I ▁can ' t ▁bring ▁myself ▁to ▁do ▁such ▁a ▁thing .	▁我不能 让 自己做 这样 的事 。
▁I ' ve ▁always ▁been ▁proud ▁of ▁you .	▁我一直 为 您 骄傲 。
▁Tell ▁me ▁again ▁where ▁you ▁live .	▁再 跟我说 一次 , 你 住 哪 ?
▁I ▁usually ▁go ▁to ▁school ▁by ▁bicycle .	▁我通常 骑 自行车 去上学 。
▁I ▁know ▁this ▁hasn ' t ▁been ▁easy ▁for ▁you .	▁我知道 这 对 于 你不 容易 。
▁I ' m ▁used ▁to ▁staying ▁up ▁late ▁at ▁night .	▁我 习惯 晚 睡 。
▁She ▁wants ▁to ▁work ▁at ▁the ▁hospital .	▁她想 在医院 工作 。
▁I ▁don ' t ▁know ▁whether ▁I ▁have ▁time ▁or ▁not .	▁我不知道 我 有 没有 时间 。
▁Do ▁you ▁know ▁anyone ▁who ' s ▁not ▁on ▁Facebook ?	▁你有 认识 没有 用 Facebook 的人 吗 ?
▁This ▁year ' s ▁fash ions ▁are ▁completely ▁different ▁from ▁last ▁year ' s .	▁ 今年 的 时 尚 潮 流 完全 不同 于 去年 。
▁L end ▁me ▁some ▁books ▁to ▁read .	▁ 借我 一些 书 看 。
▁The ▁whole ▁aud ience ▁er up ted ▁in ▁l aughter .	▁ 哄 堂 大 笑 。
▁The ▁book ▁was ▁pub l ished ▁in ▁16 89 .	▁这本书 出 版 于 16 89 年 。
▁He ▁studies ▁cont em p or ary ▁l it er ature .	▁他 学习 现 代 文 学 。
▁The ▁doctor ▁may ▁have ▁said ▁so .	▁医生 可能 说过 。
▁How ▁long ▁does ▁the ▁airport ▁bus ▁take ▁to ▁the ▁airport ?	▁ 乘 机场 大 巴 去 机场 要 多久 ?
▁He ▁doesn ' t ▁real ise ▁that ▁he ' s ▁ton e ▁de a f .	▁他 不知道 他 自己 五 音 不 全 。
▁I ' d ▁like ▁to ▁speak ▁with ▁you ▁in ▁private .	▁我想 跟你 私 下 说话 。
▁I ▁feel ▁like ▁another ▁beer .	▁我想 再来 一杯 啤酒 。
▁This ▁store ▁is ▁cur ren t ly ▁sell ing ▁vegetables .	▁这家 店 在 卖 蔬菜 。
▁Close ▁your ▁eyes .	▁ 闭 上 你们的 眼睛 。
▁I ▁can ' t ▁change ▁what ▁happened ▁yesterday .	▁我没 法 改变 昨天 发生 的事情 。
▁My ▁mother ▁hat es ▁writing ▁letters .	▁我妈妈 讨厌 写信 。
▁T ime ▁for ▁dinner .	▁ 吃饭 时间 到了 。
▁An im als ▁are ▁afraid ▁of ▁fire .	▁ 动物 怕 火 。
▁I ▁work ▁for ▁a ▁bank .	▁我为 一家 银行 工作 。
▁T ear s ▁filled ▁her ▁eyes .	▁她 热 泪 盈 眶 。
▁Would ▁you ▁lend ▁me ▁a ▁pencil ?	▁能 借我 支 铅笔吗 ?
▁I ▁doubt ▁if ▁Tom ▁is ▁single .	▁我 怀疑 汤姆 是 单 身 。
▁We ▁had ▁a ▁lot ▁of ▁snow ▁last ▁year .	▁去年 下了 很多 雪 。
▁I ' m ▁sick ▁of ▁eating ▁fast ▁food .	▁我受 够 吃 快 餐 了 。
▁He ▁got ▁his ▁wife ▁to ▁m end ▁his ▁shirt .	▁他 让 他的 妻子 补 好 衬衫 。
▁The ▁present ▁time ▁is ▁a ▁good ▁time .	▁现在 正 是 好 时候 。
▁Yesterday ▁was ▁my ▁se vent e ent h ▁birthday .	▁昨天 是我 1 7 岁 生日 。
▁In ▁order ▁to ▁do ▁that , ▁you ▁have ▁to ▁take ▁risk s .	▁要 这么 做 , 你 需要 冒 险 。
▁I ▁prefer ▁red ▁wine ▁to ▁white .	▁我喜欢 红 葡萄酒 胜过 白 葡萄酒 。
▁Tom ▁is ▁very ▁kind .	▁汤姆 人 很好 。
▁He ▁is ▁un s at isfied ▁with ▁the ▁result .	▁他对 结果 不 满意 。
▁The ▁telephone ▁was ▁inv ented ▁in ▁1 8 7 6 ▁by ▁B ell .	▁电话 于 1 8 7 6 年 由 贝 尔 所 发 明 。
▁My ▁uncle ▁never ▁writ es ▁letters .	▁我的 叔叔 从来不 写信 。
▁Both ▁French ▁and ▁English ▁are ▁spoken ▁in ▁Canada .	▁在 加拿大 的人 说法语 和 英语 。
▁We ▁had ▁an ▁un p leas ant ▁experience ▁there .	▁我们在 那里 有一个 不 愉快 的 经 历 。
▁She ' ll ▁cry ▁even ▁when ▁no ▁one ▁is ▁looking .	▁没人 盯 着 她的 时候 , 她 甚至 会 哭 。
▁The ▁rain ▁is ▁be ating ▁against ▁the ▁window s .	▁雨 点 打 着 窗户 。
▁What ' s ▁wrong , ▁h oney ?	▁ 出 什么事 了 , 宝 贝 ?
▁I ' m ▁sorry ▁to ▁dis app oint ▁you .	▁我对 让你 失望 感到 抱歉 。
▁I ▁never ▁want ▁to ▁leave ▁Boston .	▁我从 不想 离开 波士顿 。
▁I ▁didn ' t ▁mean ▁to ▁wake ▁you .	▁我没 打算 叫醒 你 。
▁My ▁opinion ▁is ▁different ▁from ▁yours .	▁我的 看法 跟 你的 不同 。
▁The ▁policeman ▁a im ed ▁his ▁gun ▁at ▁the ▁man .	▁警察 瞄 准 了 那个 男人 。
▁My ▁aunt ▁made ▁me ▁a ▁new ▁skirt .	▁我 婶 婶 做了一 条新裙子 给我 。
▁He ▁likes ▁watching ▁baseball ▁games ▁on ▁TV .	▁他喜欢 看电视 上的 棒球 比赛 。
▁You ▁ought ▁to ▁thank ▁him .	▁你应该 感谢 他 。
▁Mary ▁had ▁to ▁go ▁to ▁school .	▁玛丽 必须 去上学 。
▁She ▁is ▁more ▁pretty ▁than ▁beautiful .	▁ 说她 美 不 如 说她 可爱 。
▁My ▁house ▁is ▁close ▁to ▁a ▁bus ▁stop .	▁我的 房子 靠 近 一个 公 车站 牌 。
▁We ▁give ▁a ▁10 % ▁disc ount ▁for ▁cash .	▁ 如 用 现 金 付 款 , 我们 给 予 九 折 优 惠 。
▁I ▁can ' t ▁blame ▁Tom ▁for ▁not ▁waiting .	▁我不能 怪 汤姆 不 等 著 。
▁We ▁have ▁to ▁do ▁our ▁best .	▁我们要 尽力 而为 。
▁Tom ▁listen ed ▁carefully .	▁汤姆 仔细 听 。
▁I ▁received ▁your ▁letter .	▁我 收 到了 您的 信 。
▁Is ▁he ▁still ▁interested ?	▁他 还有 兴趣 吗 ?
▁You ▁should ▁pay ▁your ▁rent ▁in ▁adv ance .	▁你应该 提 前 付 租 金 。
▁It ' s ▁been ▁a ▁long ▁time .	▁已经 很长 一 段 时间 了 。
▁It ' s ▁fair ly ▁warm ▁today .	▁今天 相当 暖 和 。
▁You ▁look ▁sleepy .	▁你看起来很 困了 。
▁Every ▁time ▁it ▁rains , ▁the ▁r oof ▁le ak s .	▁每 次 下雨 屋 顶 就 漏 水 。
▁Tom ▁said ▁he ▁loved ▁me .	▁汤姆说他 爱我 。
▁Please ▁answer ▁this ▁question ▁for ▁me .	▁请 回答 我 这个问题 。
▁I ▁think ▁this ▁coat ▁should ▁fit ▁you .	▁我认为 这 外套 应该 适合 你 。
▁When ▁I ▁opened ▁the ▁door , ▁I ▁found ▁him ▁asleep .	▁当我 打开 门 的时候 , 我 发现 他 睡着了 。
▁His ▁plan ▁was ▁disc ard ed .	▁他的 计划 被 驳 回 了 。
▁What ' s ▁the ▁problem ▁with ▁your ▁computer ?	▁你的 电脑 有什么 问题 ?
▁An ▁apple ▁sit s ▁on ▁the ▁table .	▁桌 上有个 苹果 。
▁I ▁don ' t ▁know ▁what ▁I ' m ▁doing .	▁我不知道 我在 做甚么 。
▁Many ▁people ▁only ▁speaks ▁one ▁language .	▁许多 人 只 说 一 种 语言 。
▁That ▁white ▁par as ol ▁is ▁her s .	▁那 把 白 色 阳 伞 是 她的 。
▁I ' m ▁going ▁to ▁tell ▁you ▁the ▁truth .	▁我要 告诉你 真相 。
▁I ▁go ▁to ▁bed ▁very ▁early .	▁我很 早就 去睡觉 。
▁Do ▁you ▁have ▁a ▁temper ature ?	▁你 发烧 了吗 ?
▁They ▁say ▁that ▁old ▁house ▁is ▁ha un ted .	▁据 说 老 房子 闹 鬼 。
▁Not ▁every ▁country ▁belong s ▁to ▁the ▁U . N .	▁不是 所有 国家 都 加 入了 联 合 国 。
▁If ▁you ▁are ▁not ▁going ▁to ▁the ▁concert , ▁then ▁ne ither ▁am ▁I .	▁如果你 不去 音乐会 , ▁我 也不 去 。
▁Be aut y ▁is ▁in ▁the ▁eye ▁of ▁the ▁beh old er .	▁ 情 人 眼 里 出 西 施 。
▁Tom ▁used ▁a ▁fire ▁ex ting u is her ▁to ▁try ▁and ▁put ▁the ▁fire ▁out .	▁汤姆 试著 用 灭 火 器 把 火 扑 灭 。
▁That ▁car ▁is ▁really ▁expensive .	▁那 辆 汽车 真的很 贵 。
▁She ▁left ▁home ▁ten ▁minutes ▁ago .	▁她 十分钟 前 离 家 。
▁Whose ▁car ▁is ▁this ?	▁这是 谁的 车 ?
▁His ▁words ▁surprised ▁me .	▁他的 话 让我 吃惊 。
▁" W here ' s ▁your ▁book ?" ▁" O n ▁the ▁table ."	▁ 「 你的 书 在哪 ? 」 「 在 桌上 。 」
▁That ▁is ▁the ▁office ▁where ▁he ▁works .	▁那是 他 工作 的 办公室 。
▁We ▁managed ▁to ▁get ▁some ▁foreign ▁stamps .	▁我们 设法 得到 一些 外国 的 邮票 。
▁She ▁speaks ▁Chinese .	▁她 讲 中文 。
▁Could ▁you ▁bring ▁my ▁breakfast ▁to ▁room ▁30 5 ?	▁你可以 把我的 早餐 送 到 30 5 房间 吗 ?
▁I ' m ▁going ▁to ▁stop ▁trying ▁to ▁be ▁friend ly ▁with ▁you .	▁我不 跟你 要 好了 。
▁How ▁much ▁is ▁your ▁month ly ▁gas ▁bill ?	▁你 每个 月 的 瓦 斯 费 多少钱 ?
▁Y es , ▁I ▁have ▁a ▁good ▁idea .	▁是 的 , 我 有一个 好 主意 。
▁The ▁last ▁person ▁I ▁told ▁my ▁idea ▁to ▁thought ▁I ▁was ▁n ut s .	▁ 最后 一个 听我 说 我的 主意 的人 认为我 疯了 。
▁He ▁plays ▁very ▁well .	▁他 弹 得很好 。
▁Wait ▁a ▁moment .	▁请 稍 等 。
▁Tom ▁has ▁always ▁been ▁very ▁nice ▁to ▁me .	▁汤姆 对我 一直 很好 。
▁She ▁f umb led ▁with ▁a ▁piece ▁of ▁paper .	▁她 摸 索 著 一张 纸 。
▁I ▁can ' t ▁imag ine ▁life ▁on ▁another ▁planet .	▁我无法 想象 另一个 星 球 上的 生 物 。
▁I ▁have ▁to ▁go ▁to ▁bed .	▁我该 上床 了 。
▁We ▁took ▁turn s ▁with ▁the ▁driving .	▁我们 轮 流 驾驶 。
▁In no c ence ▁is ▁a ▁beautiful ▁thing .	▁ 纯 真 是一 件 美 好 的事 。
▁Give ▁her ▁the ▁book .	▁把 这本书 给她 。
▁You ' d ▁better ▁eat ▁something .	▁你最好 吃点 东西
▁Have ▁you ▁ever ▁been ▁rob bed ?	▁你 被 抢 劫 过 吗 ?
▁Your ▁plan ▁requ ire s ▁a ▁large ▁amount ▁of ▁money .	▁你的 计划 需要 一 大 笔钱 。
▁She ▁got ▁her ▁daughter ▁a ▁person al ▁computer .	▁她给 她的 女儿 买了一 台 个人 电脑 。
▁Tom , ▁I ▁want ▁to ▁talk ▁to ▁Mary .	▁汤姆 , 我想 跟玛丽 谈话 。
▁He ▁wants ▁to ▁go ▁to ▁Af ric a .	▁他 想要 去 非 洲 。
▁He ▁received ▁quite ▁a ▁few ▁letters ▁this ▁morning .	▁今天早上 他 收到 好多 信 。
▁People ▁should ▁be ▁d anc ing .	▁人们 应该 在 跳舞 。
▁Does ▁Tom ▁drink ▁coffee ?	▁汤姆 喝 咖啡吗 ?
▁I ▁caught ▁three ▁fish ▁yesterday .	▁昨天我 钓 了 三 条 鱼 。
▁I ▁was ▁se ar ched ▁by ▁the ▁c ust om s ▁off ic ers ▁at ▁the ▁airport .	▁我在 机场 被 海 关 人 员 搜 查 。
▁She ▁is ▁a ▁teacher .	▁她是 女 教师 。
▁He ▁is ▁tall .	▁他 高 。
▁I ▁love ▁her ▁so ▁much ▁I ▁could ▁die .	▁爱 她 爱 得 要 命 。
▁Somet imes ▁you ▁get ▁luck y .	▁你有 时候 真 走 运 。
▁Tom ▁ate ▁half ▁the ▁cake ▁by ▁himself .	▁汤姆 独自 吃了 半 个 蛋糕 。
▁One ▁hundred ▁years ▁is ▁called ▁a ▁cent ury .	▁一 百 年 称 为 一个 世纪 。
▁Why ▁did ▁you ▁say ▁such ▁a ▁thing ?	▁你为什么 说了 这样 的事 ?
▁Tom ▁really ▁doesn ' t ▁like ▁you .	▁汤姆 真的 不喜欢 你 。
▁I ▁had ▁never ▁seen ▁a ▁wind m ill ▁until ▁I ▁visited ▁the ▁N et her land s .	▁在 我去 荷 兰 之前 , 我 从 没见过 风 车 。
▁You ▁ought ▁to ▁have ▁come ▁to ▁see ▁me ▁yesterday .	▁你昨天 应该 来看 我的 。
▁This ▁water ▁tast es ▁good .	▁这 水 很好 喝 。
▁Do ▁you ▁believe ▁in ▁ghosts ?	▁你相信 有 鬼 魂 吗 ?
▁Would ▁you ▁lend ▁me ▁your ▁pencil ?	▁你可以 借我 你的 铅笔吗 ?
▁It ' s ▁a ▁p ity ▁when ▁some body ▁d ies .	▁有人 死了 的时候 真是 遗憾 。
▁Why ▁should ▁it ▁be ▁different ?	▁为什么 它 应该 要 变 得不 一样 ?
▁Did ▁you ▁go ▁to ▁the ▁art ▁ex hib ition ?	▁你 去看 艺术 展 览 了吗 ?
▁No ▁one ▁knows .	▁没有人 知道 。
▁She ▁hit ▁the ▁ball ▁hard .	▁她用 力 地 拍 了 球 。
▁You ▁have ▁already ▁eaten ▁the ▁cake .	▁你 已经 把 蛋糕 吃了 。
▁I ▁like ▁pop ▁music .	▁我喜欢 流行 音乐 。
▁There ▁is ▁a ▁sp oon ▁missing .	▁ 少 了一 把 勺 子 。
▁I ▁went ▁for ▁a ▁walk ▁in ▁the ▁park .	▁我去 公园 散 了 步 。
▁I ' ll ▁always ▁love ▁you , ▁no ▁matter ▁what ▁happens .	▁不 论 发生了什么事 , 我会 永远 爱你 。
▁Tom ▁really ▁needs ▁help ▁now .	▁汤姆现在 真的 需要 帮助 。
▁He ▁is ▁a ▁learned ▁man .	▁他是个 有 教 养 的人 。
▁She ▁teac hes ▁reading ▁and ▁writing .	▁她 教 阅读 和 写 作 。
▁I ▁dis l ike ▁big ▁c ities .	▁我不喜欢 大 城市 。
▁E b ol a ▁sp read s ▁from ▁person ▁to ▁person ▁through ▁bo d ily ▁flu id s .	▁ 埃 博 拉 通过 体 液 在 人 与 人 之间 传 播 。
▁I ▁think ▁it ' s ▁OK .	▁我想 没关系 。
▁We ' ll ▁always ▁be ▁friends .	▁我们 永远 都会 是 朋友 。
▁We ▁can ' t ▁esc ape .	▁我们 逃 不 出去 。
▁My ▁mother ▁never ▁gets ▁up ▁early .	▁我的 母亲 从不 早起 。
▁Tom ▁care s ▁about ▁you .	▁汤姆 关心 你 。
▁Do ▁you ▁want ▁to ▁go , ▁too ?	▁你 也 要去 吗 ?
▁I ▁thought ▁pizza ▁was ▁what ▁you ▁wanted ▁to ▁eat .	▁我认为 你想 吃 的是 比萨 。
▁Why ▁didn ' t ▁you ▁turn ▁up ▁on ▁Saturday ?	▁你 为 何 周 六 没来 ?
▁He ▁does ▁speak ▁well .	▁他 真的 说 得很好 。
▁M ore ▁and ▁more ▁people ▁are ▁mo ving ▁to ▁ ur b an ▁are as .	▁ 越来越 多 的人 迁 往 乡 村 。
▁My ▁sister ▁made ▁me ▁a ▁beautiful ▁doll .	▁我妹妹 做了一个 漂亮的 娃娃 给我 。
▁I ▁heard ▁the ▁door ▁close .	▁我听到 门 关 了 。
▁We ' ll ▁do ▁that .	▁我们 会 去做 。
▁He ming way ▁enjoyed ▁big ▁game ▁hun ting ▁in ▁Af ric a .	▁海 明 威 喜欢 在 非 洲 的 大 狩 猎 。
▁Tom ▁watched ▁TV ▁yesterday .	▁Tom 昨天 看了 电视 。
▁Can ▁I ▁sit ▁here ?	▁我能 坐 这里 吗 ?
▁How ▁long ▁ago ▁did ▁the ▁bus ▁leave ?	▁这辆 公车 多久 前 离开 的 ?
▁I ▁don ' t ▁remember .	▁我不记得 了 。
▁Can ▁we ▁do ▁it ?	▁我们能 做到 吗 ?
▁Why ▁were ▁you ▁late ?	▁你为什么 迟到 ?
▁Tom ▁needs ▁the ▁money .	▁汤姆需要 钱 。
▁I ' ll ▁lend ▁you ▁my ▁te xt book .	▁我会 借 给你 我的 课 本 。
▁Did ▁you ▁actually ▁see ▁the ▁accident ?	▁你真的 看到了 这 起 事故 吗 ?
▁Did ▁you ▁go ▁to ▁school ?	▁你 去学校 了吗 ?
▁I ▁am ▁dis g ust ed ▁with ▁him .	▁我 厌 恶 他 。
▁I ▁have ▁plenty ▁of ▁money ▁with ▁me .	▁我 身上 带 著 很多钱 。
▁She ▁seems ▁to ▁be ▁unhappy .	▁她 看起来 不 快乐 。
▁How ▁many ▁CD s ▁do ▁you ▁have ?	▁你有 多少 张 CD ?
▁Tom ▁got ▁a ▁late ▁start ▁this ▁morning .	▁汤姆 今 早 出发 晚了 。
▁I ▁bought ▁her ▁a ▁nice ▁Christmas ▁present .	▁我 给她 买 了一个 不错 的 圣诞 礼物 。
▁His ▁decision ▁to ▁ret ire ▁surprised ▁all ▁of ▁us .	▁他要 退休 的 决定 让我们 都 感到 吃惊 。
▁You ▁and ▁I ▁have ▁the ▁same ▁idea .	▁你 和我 有 相同 的 想法 。
▁It ' s ▁to t ally ▁dark ▁outside .	▁ 外面 一 片 漆 黑 。
▁I ▁can ▁cook .	▁我会 做饭 。
▁E v ident ly , ▁it ' s ▁going ▁to ▁rain ▁tomorrow .	▁明天 肯定 会 下雨 。
▁I ▁want ▁a ▁m ass age . ▁I ▁need ▁to ▁relax .	▁我想要 按 摩 。 我 需要 放松 。
▁He ▁is ▁begin ning ▁to ▁lose ▁his ▁hair .	▁他 开始 掉 头发 了 。
▁We ▁must ▁try ▁to ▁break ▁the ▁dead l ock .	▁我们必须 设法 打破 这个 僵 局 。
▁Money ▁rules ▁the ▁world .	▁ 金钱 万 能 。
▁What ▁he ▁said ▁is ▁not ▁true .	▁他 说的话 不是真的 。
▁The ▁telephone ▁rang ▁a ▁few ▁minutes ▁later .	▁几 分钟 后 , 电话 响了 。
▁Tom ▁worked ▁very ▁hard ▁and ▁ear ned ▁a ▁lot ▁of ▁money .	▁汤姆 努力工作 挣 了 好多 钱 。
▁Don ' t ▁pull ▁my ▁le g !	▁不要 拉 我的 腿 !
▁You ▁may ▁use ▁my ▁new ▁car .	▁你可以 使用 我的 新车 。
▁I ' ll ▁person ally ▁visit ▁you .	▁我会 亲 自 拜访 您 。
▁I ' m ▁sorry , ▁I ▁didn ' t ▁hear ▁you .	▁对不起 , 我没有 听 见你 说话 。
▁Could ▁you ▁turn ▁down ▁the ▁radio ?	▁您能 把 收音机 开 小 声 一点 吗 ?
▁Tom ' s ▁co ach ▁likes ▁him .	▁汤姆的 教 练 喜欢 他 。
▁P aper ▁burn s ▁quickly .	▁ 纸 烧 得 快 。
▁I ' d ▁like ▁to ▁stay ▁for ▁one ▁night .	▁我想 待 一 夜 。
▁B es ides ▁the ▁piano , ▁can ▁you ▁play ▁any ▁other ▁in str ument s ?	▁除了 钢琴 以 外 , 还 会 玩 什么 乐 器 吗 ?
▁We ▁can ' t ▁stay ▁in ▁here ▁very ▁long .	▁我们不能 在这里 待 很长 时间 。
▁Her ▁birthday ▁party ▁will ▁be ▁tomorrow ▁evening .	▁她的 生日 宴 会 将在 明天 晚上 。
▁You ▁look ▁tired .	▁你看起来很 困了 。
▁We ▁happened ▁to ▁get ▁on ▁the ▁same ▁bus .	▁我们 恰 巧 上了 同 一辆 公交车 。
▁You ▁must ▁go ▁to ▁bed ▁now .	▁你现在 必须 上床 睡觉 。
▁Can ▁you ▁swim ?	▁你会 游泳吗 ?
▁W ash ▁your ▁face ▁and ▁hands .	▁ 洗 你的 脸 和 手 。
▁He ▁has ▁a ▁good ▁know led ge ▁of ▁French .	▁她很 懂 法语 。
▁My ▁ap artment ▁is ▁on ▁the ▁four th ▁floor .	▁我的 公 寓 在 四 楼 。
▁In ▁London , ▁the ▁police ▁are ▁always ▁worried ▁about ▁finding ▁a ▁b om b ▁on ▁the ▁train ▁or ▁sub way .	▁在 伦敦 , 警察 总是 担心 在 列车 上 发现 炸 弹 。
▁I ▁just ▁wanted ▁to ▁check ▁my ▁em ail .	▁我只想 查 一下 我的 电 子 邮 件 。
▁This ▁book ▁is ▁quite ▁difficult .	▁这本书 很难 读 。
▁H app y ▁is ▁the ▁man ▁who ▁is ▁cont ented .	▁ 知 足 常 乐 。
▁I ' ve ▁been ▁told ▁Tom ▁is ▁going ▁to ▁be ▁fired .	▁有人 告诉过 我 汤姆 要 被 开 除 。
▁Someone ▁has ▁been ▁here .	▁有人 来 过 这里 。
▁Get ▁them ▁before ▁they ▁get ▁us .	▁在 他们 控制 我们 之前 , 我们 先 制 服 他们 。
▁I ▁don ' t ▁know ▁what ▁to ▁say .	▁我不知道 说什么 。
▁Tom ▁took ▁a ▁step ▁back ward .	▁汤姆 后 退 一 步 。
▁I ▁asked ▁him ▁to ▁wait ▁here .	▁我请 他 在这里等 。
▁I ▁asked ▁her ▁to ▁wait ▁a ▁minute .	▁我 让她 等 了一 分钟 。
▁Could ▁you ▁teach ▁me ▁how ▁to ▁play ▁the ▁piano ?	▁您能 教我 弹钢琴 吗 ?
▁Don ' t ▁shout ▁at ▁me .	▁别 对 著 我 吼 。
▁How ▁about ▁another ▁round ?	▁再 来 一 轮 怎么样 ?
▁I ▁can ' t ▁do ▁any ▁better .	▁我 做得 好 到 不能 再 好了 。
▁She ▁wore ▁a ▁red ▁dress .	▁她穿 了一 条 红色的 裙子 。
▁Do ▁you ▁want ▁some ▁more ▁tea ?	▁您想 再来 点 茶吗 ?
▁Our ▁car ▁is ▁equ i pped ▁with ▁air ▁cond ition ing .	▁我们的 车 配 备 了 空 调 。
▁It ▁has ▁been ▁raining ▁since ▁last ▁Th ur s day .	▁从 上 周 四 开始 一直 下雨 。
▁He ▁and ▁I ▁walked ▁together .	▁我和 他 一起走 。
▁I ▁have ▁finished ▁my ▁homework .	▁我已经 完成 我的 作业 。
▁That ▁bridge ▁is ▁very ▁beautiful .	▁那 座桥 很 漂亮 。
▁He ' s ▁scared ▁of ▁that ▁dog .	▁他怕 那 只狗 。
▁She ' s ▁in ▁the ▁rest room .	▁她在 上 厕 所 。
▁In t erest ▁r ates ▁and ▁inf l ation ▁were ▁high .	▁ 利 率 和 通 货 膨 胀 很高 。
▁What ▁is ▁your ▁phone ▁number ?	▁你 电话号码 是多少 ?
▁I ▁wish ▁you ▁had ▁come ▁with ▁us .	▁要 是你 和 我们 一起来 就好了 。
▁Some ▁people ▁relax ▁by ▁reading .	▁一些 人 通过 阅读 来 放松 。
▁The ▁young est ▁daughter ▁is ▁except ionally ▁beautiful .	▁ 么 女 长 得 特别 漂亮 。
▁I ▁feel ▁like ▁a ▁rest .	▁我想 休息 一下 。
▁Were ▁you ▁at ▁home ▁yesterday ?	▁昨天 你不 在家 吗 ?
▁I ▁have ▁to ▁ask ▁you ▁something .	▁我得 问你 点 事 。
▁Wait ▁just ▁a ▁moment .	▁就 等 一会儿 。
▁No ▁problem ▁at ▁all !	▁ 什么 问题 都没有 !
▁Are ▁you ▁absolutely ▁certain ▁about ▁this ?	▁你 绝对 确定 这事 吗 ?
▁Please ▁close ▁the ▁door ▁behind ▁you .	▁请 随 手 关门 。
▁I ▁don ' t ▁appro ve ▁your ▁decision .	▁我不 同意 你的 决定 。
▁He ▁walks ▁his ▁dog ▁every ▁morning .	▁他 每天 早 晨 溜 狗 。
▁He ▁forgot ▁to ▁turn ▁off ▁the ▁light .	▁他 忘了 关灯 。
▁Would ▁you ▁like ▁to ▁come ?	▁你 愿意 来吗 ?
▁Is ▁something ▁wrong ?	▁有 什么 不 对 吗 ?
▁He ▁n ar row ly ▁esc ap ed ▁being ▁killed .	▁他 险 些 被 杀 害 。
▁They ▁broke ▁into ▁the ▁j ew el ry ▁shop .	▁他们 闯 进了 珠 宝 店 。
▁I ' d ▁like ▁a ▁glass ▁of ▁water , ▁please .	▁请给我 一杯水 。
▁My ▁husband ▁ear ns ▁ $ 100 ,000 ▁a ▁year .	▁我 丈夫 一年 收 入 10 万 美元 。
▁I ▁really ▁agree ▁with ▁you .	▁我非常 同意 你 。
▁Spring ▁will ▁come ▁soon .	▁春天 快 来了 。
▁I ▁thought ▁the ▁questions ▁were ▁easy .	▁我认为 这些 问题 很容易 。
▁That ' s ▁what ▁I ▁always ▁say .	▁那是我 经常 说的 。
▁It ' s ▁a ▁p ity ▁they ' re ▁getting ▁divorced .	▁很 遗憾 他们 离婚 了 。
▁Tom ▁wants ▁to ▁learn ▁box ing , ▁but ▁his ▁mother ▁thinks ▁it ' s ▁too ▁dangerous .	▁汤姆想 学 拳 击 , 但他 妈妈 觉得 这 太 危险 了 。
▁This ▁d at a ▁isn ' t ▁acc ur ate ▁at ▁all .	▁这个 数 据 一点也不 准 确 。
▁Tom ▁made ▁a ▁list ▁of ▁pl aces ▁he ▁wants ▁to ▁visit .	▁汤姆把 他 想去 的地方 列 成 了一 张 清 单 。
▁Tom ▁says ▁he ▁feel s ▁a ▁little ▁better .	▁汤姆说他 感觉 好 点了 。
▁Tom ▁v an ished .	▁汤姆不 见 了 。
▁Please ▁feel ▁free ▁to ▁ask ▁questions .	▁ 欢迎 随时 提 问 。
▁It ▁has ▁been ▁raining ▁since ▁Sunday .	▁从 周日 开始 一直 在 下雨 。
▁I ▁still ▁have ▁a ▁question .	▁我还 有个 问题 。
▁He ▁dro ve ▁the ▁car , ▁listening ▁to ▁music ▁on ▁the ▁radio .	▁他一 面 开车 一 面 听收音机 的 音乐 。
▁I ▁don ' t ▁know ▁when ▁he ' ll ▁come ▁again .	▁我不知道他 什么时候 会 再 来的 。
▁We ' re ▁still ▁a ▁little ▁confused .	▁我们 还是 有点 疑 惑 。
▁She ▁lives ▁in ▁a ▁large ▁house .	▁她 住在 一 栋 大 房子 里 。
▁Some ▁people ▁cr itic ized ▁our ▁decision .	▁一些 人 批 评 了 我们的 决定 。
▁Don ' t ▁enter ▁the ▁room ▁without ▁perm ission .	▁ 未 经 允许 请 勿 进入 这个房间 。
▁Look ▁back !	▁ 回 头 看 !
▁Please ▁exc use ▁me ▁for ▁being ▁rude .	▁请 原谅 我的 鲁 莽 。
▁That ▁factory ▁makes ▁to ys .	▁那 家 工厂 生 产 玩具 。
▁Turn ▁off ▁the ▁TV .	▁ 关 闭 电视机
▁I ▁know ▁that ▁can ' t ▁really ▁happen .	▁我知道 那 不会 真的 发生 。
▁The ▁building ▁is ▁seven ▁st ories ▁high .	▁这 栋 建筑 物 有 七 层 楼 高 。
▁She ▁gave ▁up ▁everything ▁for ▁her ▁children .	▁为了 孩子们 她 放弃 了一 切 。
▁I ▁drive ▁every where .	▁我 去哪里 都 开车 。
▁You ▁will ▁be ▁able ▁to ▁see ▁him ▁tomorrow .	▁明天 你可以 看到 他 。
▁It ' s ▁difficult ▁to ▁do ▁that .	▁那么 做 很难 。
▁So ccer ▁is ▁more ▁popular ▁than ▁tennis .	▁ 足球 比 网球 更 受欢迎 。
▁Where ▁am ▁I ?	▁这是什么 地方 ?
▁" H e ▁used ▁to ▁love ▁me ," ▁she ▁answered ▁sad ly .	▁他 以前 爱我 , 她 伤 心 地 回答 。
▁This ▁is ▁not ▁a ▁sentence .	▁这不是 一 句话 。
▁It ' s ▁just ▁big ▁enough ▁for ▁Tom .	▁这 尽 够 汤姆的 。
▁That ' s ▁what ▁Tom ▁promised .	▁那是 汤姆 承诺 的 。
▁What ▁subject ▁do ▁you ▁like ▁best ?	▁你最喜欢 哪 一个 科目 ?
▁Some ▁of ▁the ▁bl u est ▁water ▁in ▁the ▁world ▁is ▁found ▁in ▁C r ater ▁L ake .	▁一些 世界上 最 蓝 的 水 在 火 山 湖 。
▁It ▁was ▁just ▁a ▁j oke . ▁L ight en ▁up !	▁只 是个 玩笑 。 放松 点 !
▁His ▁explanation ▁is ▁not ▁clear .	▁他的 说明 并不 清楚 。
▁Tom ▁always ▁seems ▁to ▁be ▁working .	▁汤姆看来 总是 在 工作 。
▁You ▁drink ▁too ▁much ▁coffee .	▁你 咖啡 喝 得 太多了 。
▁She ▁made ▁a ▁new ▁suit ▁for ▁him .	▁她 做了一 套 新 衣服 给他 。
▁I ' m ▁b le ed ing .	▁我在 流 血 。
▁Do ▁you ▁really ▁want ▁Tom ▁to ▁su ff er ?	▁你真 想 让汤姆 受 苦 吗 ?
▁An ▁old ▁man ▁broke ▁into ▁our ▁conversation .	▁一 位 老人 打 断了 我们的 谈话 。
▁Tom ▁made ▁up ▁his ▁mind ▁to ▁become ▁a ▁newspaper man .	▁汤姆 决定 做 报 业 人 士 。
▁These ▁glasses ▁are ▁c ool .	▁这些 眼镜 真 酷 。
▁Tom ▁is ▁working ▁the ▁night ▁sh ift .	▁汤姆 上 夜 班 。
▁You ' ve ▁g ained ▁weight , ▁haven ' t ▁you ?	▁你的 体重 增加 了 , 不是吗 ?
▁I ' ve ▁had ▁a ▁good ▁sleep .	▁我 睡 得很好 。
▁His ▁br az en ▁act ▁of ▁def ian ce ▁almost ▁cost ▁him ▁his ▁life .	▁他 怀疑 的 无 耻 行为 差点 要 了他的 命 。
▁He ▁brought ▁us ▁sad ▁news .	▁他 给我们 带 来了 令人 难 过 的 消息 。
▁Would ▁you ▁like ▁to ▁go ?	▁你想 去 吗 ?
▁I ▁fe ed ▁my ▁cat ▁every ▁morning ▁and ▁every ▁evening .	▁ 每天 早 晚 , 我 给我的 猫 喂 食 。
▁They ▁must ▁really ▁hate ▁me .	▁他们 一定 很 恨 我 。
▁A ▁great ▁respons ib ility ▁li es ▁on ▁his ▁should ers .	▁他 身 肩 重 任 。
▁Please ▁fe ed ▁the ▁dog ▁every ▁day .	▁请 每天 喂 一下 狗 。
▁This ▁wh is k y ▁is ▁too ▁strong .	▁这 种 威 士 忌 太 烈 了 。
▁I ▁was ▁in ▁school ▁yesterday ▁morning .	▁昨天 上午 我在 学校 。
▁This ▁is ▁a ▁great ▁moment .	▁这是一个 伟大的 时 刻 。
▁You ▁can ▁probably ▁guess ▁what ▁happens ▁th ough .	▁但 你 很 可能 猜 得到 会发生 什么 。
▁I ▁prefer ▁red ▁wine ▁to ▁white ▁wine .	▁我喜欢 红 葡萄酒 胜过 白 葡萄酒 。
▁The ▁police ▁broke ▁up ▁the ▁fight .	▁警察 驱 散 了这 场 斗 殴 。
▁I ▁want ▁the ▁same ▁jacket ▁as ▁you ▁are ▁wearing .	▁我也 想要 和你 身上 那 件 同 样的 外套 。
▁The ▁street ▁was ▁crowd ed ▁with ▁people .	▁ 街 道 上 挤 满了 人 。
▁She ▁wasn ' t ▁able ▁to ▁open ▁the ▁bottle .	▁她 无法 打开 这个 瓶子 。
▁We ' re ▁not ▁in ▁Boston .	▁我们不 在波士顿 。
▁Maybe ▁Tom ▁just ▁got ▁nervous .	▁可能 汤姆 紧张 了 。
▁He ▁has ▁a ▁lot ▁of ▁or ig in al ▁ideas .	▁他有 很多 独 到 的 见 解 。
▁See ▁you ▁around .	▁再 见 !
▁I ' ve ▁already ▁eaten ▁lunch .	▁我已经 吃过 午餐 了 。
▁Let ' s ▁end ▁this ▁n ons ense .	▁让我们 结束 这 胡 言 乱 语 。
▁Tom ▁says ▁he ' s ▁not ▁feeling ▁any ▁better .	▁Tom 说他 感觉 不舒服 。
▁I ' m ▁a ▁little ▁confused .	▁我有 一点 困惑 了 。
▁I ▁don ' t ▁want ▁everyone ▁to ▁think ▁I ' m ▁stupid .	▁我不想 让 任何人 认为我 傻 。
▁His ▁rec ord ▁is ▁a ▁new ▁world ▁rec ord ▁in ▁the ▁100 - m et er ▁d ash .	▁他 刷 新 了 百 米 短 跑 的 世界 纪 录 。
▁Your ▁v iew ▁is ▁too ▁o pt im ist ic .	▁你的 看法 过 于 乐 观 。
▁Australia ▁is ▁the ▁world ' s ▁fif th - lar gest ▁co al ▁produ cer .	▁ 澳 大利 亚 是 世界 第 五 大 煤 炭 产 地 。
▁L ear ning ▁foreign ▁languages ▁is ▁boring .	▁ 学 外 文 很 无聊 。
▁My ▁grandfather ▁lived ▁to ▁be ▁n in ety .	▁我的 祖父 活 到了 九 十 岁 。
▁She ▁dec or ated ▁her ▁room ▁with ▁roses .	▁她用 玫瑰 花 装 饰 了她的 房间 。
▁Are ▁you ▁listening ?	▁你 闻 吗 ?
▁We ▁have ▁to ▁go .	▁我们必须 走了 。
▁I ▁watched ▁TV ▁this ▁morning .	▁我今天早上 看了 电视 。
▁I ' m ▁a ▁member ▁of ▁the ▁swimming ▁club .	▁我是 游泳 社 的 成员 。
▁Perhaps ▁he ▁missed ▁the ▁train .	▁他可能 错过了 火车 。
▁She ▁always ▁wears ▁black .	▁她总是 穿著 黑色的 衣服 。
▁Tom ▁didn ' t ▁try ▁to ▁h ide ▁the ▁truth .	▁汤姆 并 没有 试著 要 隐 瞒 实 情 。
▁The ▁doctor ▁c ured ▁him ▁of ▁his ▁cancer .	▁医生 治 好 了他的 癌症 。
▁I ▁have ▁to ▁go ▁to ▁bed .	▁我该 去睡觉 了 。
▁Our ▁eyes ▁take ▁time ▁to ▁ad j ust ▁to ▁the ▁dark .	▁我们的 眼睛 需要 时间 来 适 应 黑 暗 。
▁Many ▁of ▁the ▁work ers ▁died ▁of ▁hun ger .	▁许多 工 人 死于 饥饿 。
▁Cl ot hes ▁make ▁the ▁man .	▁人 要 衣 装 。
▁That ' s ▁all ▁I ▁could ▁find .	▁那是我 所有 能 找到 的 。
▁I ▁miss ▁you ▁so ▁much .	▁好 想 见到你
▁He ' s ▁sitting ▁at ▁an ▁em pt y ▁table .	▁他 坐在 一张 空 桌 旁 。
▁It ' s ▁not ▁a ▁watch .	▁这不是 手表 。
▁Tom ▁is ▁esc ap ing .	▁汤姆在 逃 跑 。
▁How ▁about ▁eating ▁out ▁this ▁evening ?	▁今天 晚上 出去 吃 怎样 ?
▁L ist en .	▁听 着 。
▁I ' m ▁so ▁stupid .	▁我真 蠢 。
▁She ▁is ▁having ▁lunch ▁now .	▁她现在 正在 吃 午餐 。
▁Are ▁those ▁expl os ive s ?	▁那些 是 爆炸 物 吗 ?
▁We ' re ▁doing ▁the ▁best ▁we ▁can .	▁我们 尽力 而为 。
▁There ▁were ▁few ▁children ▁in ▁the ▁room .	▁ 房间里 没 几个 小 孩子 。
▁Don ' t ▁blame ▁Tom ▁for ▁what ▁Mary ▁did .	▁别 为 玛丽 犯 的 错 责 备 汤姆 。
▁He ▁came ▁from ▁a ▁t in y ▁mountain ▁town .	▁他 来自 一个 小 山 城 。
▁Tom ▁isn ' t ▁feeling ▁very ▁well .	▁汤姆 感觉 不太好 。
▁I ▁was ▁aw fully ▁confused ▁by ▁his ▁question .	▁我对 他的 问题 感到 非常 困惑 。
▁The ▁dog ▁was ▁hit ▁by ▁a ▁car .	▁狗 被 车撞 了 。
▁May ▁I ▁sha re ▁this ▁table ▁with ▁you ?	▁我可以 跟你 共 用 这张 桌子 吗 ?
▁C uff ▁him .	▁把 他 铐 上 。
▁I ▁wish ▁I ▁were ▁in ▁Paris ▁now .	▁但愿我 现在 在 巴黎 。
▁He ' s ▁a ▁met h ▁add ict .	▁他是个 吸 毒 男 。
▁I ▁don ' t ▁know ▁where ▁my ▁cr ut ches ▁are . ▁Have ▁you ▁seen ▁them ?	▁我不知道 把 拐 杖 放 哪 去了 , 你有 看到 吗 ?
▁We ▁took ▁a ▁walk ▁along ▁the ▁river .	▁我们 沿 著 河 散步 。
▁Tom ▁told ▁me ▁that ▁he ▁didn ' t ▁want ▁to ▁go ▁with ▁us .	▁汤姆告诉我他 不想 跟我们 走 。
▁The ▁bus ▁was ▁two ▁minutes ▁early .	▁ 巴士 早 了 两 分钟 。
▁Do ▁you ▁often ▁have ▁fish ▁for ▁dinner ?	▁你 常常 晚餐 吃 鱼 吗 ?
▁Help ▁yourself ▁to ▁anything ▁you ▁like .	▁ 喜欢 什么 就 随便 吃 吧 。
▁It ▁is ▁strange ▁that ▁he ▁should ▁say ▁so .	▁他 这么 说 很 奇怪 。
▁We ▁want ▁f ur ther ▁information .	▁我们 想要 更多 信息 。
▁She ▁dec l ared ▁that ▁she ▁was ▁not ▁gu il ty .	▁她 声 称 自己 没 罪 。
▁He ▁advised ▁her ▁to ▁stop ▁drinking .	▁他 建议 她 戒 酒 。
▁I ▁supp ose ▁you ▁like ▁him .	▁我猜 想 您 喜欢 他 。
▁My ▁brother ▁goes ▁to ▁college ▁in ▁Tokyo .	▁我 兄弟 在 东京 上大学 。
▁There ▁are ▁no ▁ha ts ▁in ▁that ▁store ▁that ▁fit ▁me .	▁那个 店 里 没有 合 我 尺 寸 的 帽子 。
▁I ▁am ▁not ▁used ▁to ▁drinking ▁coffee ▁without ▁su g ar .	▁我不 习惯 喝 无 糖 咖啡 。
▁I ▁don ' t ▁like ▁this ▁idea .	▁我不喜欢 这个 主意 。
▁What ' s ▁your ▁occ up ation ?	▁您的 职 业 是什么 ?
▁Don ' t ▁ex ceed ▁the ▁spe ed ▁l im it .	▁不要 超 速 。
▁It ▁r arely ▁snow s ▁in ▁this ▁area .	▁这 片 区 域 很少 下雪 。
▁I ▁must ▁catch ▁the ▁first ▁train .	▁我必须 赶上 头 班火车 。
▁I ' d ▁rather ▁be ▁with ▁you .	▁我 更 愿意 跟着 你 。
▁You ' d ▁better ▁not ▁go ▁today .	▁你今天 最好 不要 去 。
▁He ▁lives ▁in ▁that ▁house ▁over ▁there .	▁他住在 那 边 的 那 间 房子 。
▁I ▁wanted ▁to ▁stop ▁Tom .	▁我想 阻止 汤姆 。
▁The ▁plane ▁f lew ▁toward ▁the ▁w est .	▁ 飞机 向 西 飞 了 。
▁She ▁was ▁was hing ▁the ▁dishes .	▁那 时 她 正在 洗 碗 。
▁I ▁brought ▁up ▁two ▁kids ▁all ▁on ▁my ▁own .	▁我 一个人 把 两个 小孩 扶 养 长大 。
▁There ▁was ▁a ▁car ▁accident ▁yesterday .	▁昨天 发生 了一 场 车 祸 。
▁You ▁must ▁do ▁it .	▁你必须 去做 。
▁You ' re ▁the ▁one ▁who ▁decided ▁to ▁do ▁this ▁job , ▁right ?	▁你是 决定 做 这个工作 的那个 人 , 对 吗 ?
▁Thanks ▁for ▁your ▁quick ▁answer .	▁谢谢 您的 迅 速 回 复 。
▁A ▁bottle ▁of ▁red ▁wine , ▁please .	▁请 来 瓶 红 酒 。
▁I ▁want ▁to ▁go ▁with ▁you .	▁我想 和你 一起去 。
▁I ▁would ▁like ▁fruit ▁juice .	▁我想要 果汁 。
▁Let ▁me ▁say ▁one ▁thing .	▁让我 说 一 件事 情 。
▁He ▁will ▁be ▁a ▁good ▁doctor .	▁他会 成为 一个 好的 医生 的 。
▁I ▁bought ▁an ▁old ▁l am p .	▁我买了一 盏 很 旧 的 灯 。
▁I ▁don ' t ▁like ▁eating ▁meat .	▁我不喜欢 吃 肉 了 。
▁The ▁doctor ▁called ▁him ▁back .	▁医生 把 他 叫 了 回来 。
▁I ▁don ' t ▁see ▁any ▁bu ll et ▁hol es .	▁我没 看见 什么 弹 孔 。
▁The ▁m useum ▁is ▁open ▁from ▁Monday ▁to ▁Fr iday .	▁ 博物 馆 周 一 到 周 五 开门 。
▁Please ▁tell ▁me ▁what ▁I ▁should ▁do .	▁请告诉我 应该 做什么 。
▁They ' ll ▁understand ▁that .	▁他们 会 明白 。
▁When ▁did ▁you ▁come ▁to ▁Japan ?	▁你 何时 来 日本 的 ?
▁As ▁is ▁ev ident ▁from ▁the ▁d at a , ▁smoking ▁is ▁not ▁dec re as ing ▁am ong ▁the ▁young .	▁数 据 表 明 年轻人 抽烟 的 现 象 没有 减 少 。
▁We ' re ▁very ▁dis app oin ted ▁in ▁you .	▁我们 对你 很 失望 。
▁I ▁don ' t ▁know ▁when ▁she ▁got ▁married .	▁我不知道 她 是 什么时候 结婚 的 。
▁Does ▁your ▁school ▁have ▁a ▁library ?	▁你的 学校 有 图书馆 吗 ?
▁America ▁is ▁a ▁country ▁of ▁im m ig r ants .	▁美国 是一个 移 民 国家 。
▁What ▁type ▁of ▁food ▁do ▁you ▁like ?	▁你喜欢 什么 样的 食物 ?
▁Could ▁you ▁please ▁re pe at ▁it ▁once ▁again ?	▁请您 再 说 一遍 好吗 ?
▁He ▁will ▁be ▁at ▁home ▁tomorrow .	▁他明天 会 在家 。
▁C ow s ▁are ▁eating ▁gr ass ▁in ▁the ▁me ad ow .	▁ 牛 在 牧 地上 吃 草 。
▁I ▁was ▁b itten ▁by ▁a ▁m os qu it o .	▁我被 蚊 子 叮 了 。
▁My ▁boy friend ▁is ▁a ▁j our n al ist .	▁我 男 朋友 是个 记 者 。
▁This ▁guitar ▁is ▁so ▁expensive ▁that ▁I ▁can ' t ▁buy ▁it .	▁这 吉他 太 贵 了 , 我没 法 买 下 。
▁I ▁took ▁it ▁for ▁gr anted ▁that ▁you ▁were ▁on ▁my ▁side .	▁我 理 所 当然 认为 你会 站在 我 这 边 。
▁I ' m ▁not ▁as ▁tall ▁as ▁you .	▁我没有 你 高 。
▁My ▁school ▁is ▁on ▁the ▁left .	▁我的 学校 在 我家 左 边 。
▁I ▁aw oke ▁to ▁find ▁it ▁snowing .	▁当我 醒 来 时 , 天 正 下 著 雪 。
▁Tom ▁has ▁been ▁on ▁the ▁wanted ▁list ▁for ▁three ▁years .	▁汤姆 已经 上 通 缉 令 三 年了 。
▁I ▁look ▁forward ▁to ▁seeing ▁you ▁again .	▁我期待 著 再次 见到你 。
▁Are ▁there ▁res er ved ▁seat s ▁on ▁the ▁train ?	▁火车 上有 预订 的 座位 吗 ?
▁You ▁should ▁drink ▁a ▁lot ▁of ▁li qu id .	▁你应该 喝 大量 的 液 体 。
▁After ▁the ▁hur ric ane , ▁their ▁house ▁was ▁a ▁w re ck .	▁ 暴风 雨 过 后 , 他们的 房子 成了 废 墟 。
▁My ▁sister ▁married ▁a ▁doctor .	▁我妹妹 嫁 给 了一个 医生 。
▁Tom ▁likes ▁to ▁kn it .	▁汤姆喜欢 编 织 。
▁They ▁must ▁have ▁arrived ▁home ▁by ▁this ▁time .	▁他们在 这个 时候 一定 已经 到家 了 。
▁I ▁made ▁a ▁few ▁chang es .	▁我 做了 点 改 动 。
▁Can ▁you ▁just ▁please ▁go ?	▁能 请你 离开 吗 ?
▁What ▁made ▁you ▁so ▁angry ?	▁ 什么 让你 这么 生气 ?
▁I ▁wish ▁I ▁could ▁buy ▁that ▁guitar .	▁但愿 我可以 买 那 把 吉他 。
▁When ▁did ▁you ▁get ▁here ?	▁你是 什么时候 来的 ?
▁It ' s ▁about ▁time ▁we ▁went ▁to ▁bed .	▁ 差不多 是 我们就 寝 的时间 了 。
▁You ▁must ▁always ▁keep ▁your ▁hands ▁clean .	▁你应该 一直 让 手 保持 干净 。
▁St ock h ol m ▁is ▁the ▁capital ▁of ▁Sw ed en .	▁ 斯 德 哥 尔 摩 是 瑞 典 的 首 都 。
▁Don ' t ▁worry ▁about ▁such ▁a ▁thing .	▁不要 担心 这样 的事情 。
▁They ▁came ▁all ▁the ▁way ▁from ▁B raz il .	▁他们 从 巴 西 远 道 而 来 。
▁We ▁would ▁like ▁you ▁to ▁come ▁to ▁our ▁party .	▁我们 希望 你来 我们的 聚会 。
▁Maybe ▁I ▁should ▁go ▁help ▁Tom .	▁ 或许 我 该 去 帮 汤姆 。
▁Don ' t ▁let ▁your ▁feelings ▁show .	▁不要 流 露 你的 感 情 。
▁Tom ▁doesn ' t ▁like ▁me .	▁汤姆不喜欢 我 。
▁I ▁am ▁writing ▁a ▁letter .	▁我正在 写 一封信 。
▁It ▁may ▁or ▁may ▁not ▁be ▁true .	▁这 可能 是真的 , 也 可能 不是 。
▁I ▁was ▁surprised .	▁我 吃惊 了 。
▁I ▁wonder ▁if ▁you ▁are ▁as ▁busy ▁as ▁we ▁are .	▁我 担心 你会 跟我们 一样 忙 。
▁We ▁failed ▁d ue ▁to ▁a ▁l ack ▁of ▁prep ar ation .	▁我们 因 缺乏 准备 而 失败了 。
▁Some h ow ▁I ▁thought ▁you ' d ▁say ▁that .	▁我 就 知道 你会 这么 说 。
▁How ▁could ▁it ▁be ▁Tom ' s ▁fault ?	▁它 怎么 能 是 汤姆的 错 ?
▁I ▁really ▁enjoyed ▁your ▁company .	▁我 真的很 喜欢 你的 陪 伴 。
▁I ▁don ' t ▁like ▁eggs .	▁我不喜欢 鸡蛋 。
▁This ▁book ▁says ▁that ▁ele p han ts ▁live ▁to ▁be ▁over ▁100 ▁years ▁old .	▁这本书 上 写 , 大 象 能 活 过 一 百 岁 。
▁Which ▁is ▁better , ▁red ▁th read ▁or ▁white ▁th read ?	▁ 哪个 更好 , 红 线 呢 还是 白 线 ?
▁We ▁helped ▁them ▁as ▁well .	▁我们 也 帮助 他们 。
▁You ▁really ▁are ▁rude , ▁aren ' t ▁you ?	▁你 真的很 粗 鲁 , 不是吗 ?
▁The ▁street s ▁in ▁Tokyo ▁are ▁full ▁on ▁Saturday s .	▁ 周 六 , 东京 街 上 人 满 为 患 。
▁I ▁changed ▁my ▁address ▁last ▁month .	▁上 个月 我 换 了我的 地址 。
▁You ▁can ▁have ▁this ▁watch ▁for ▁nothing .	▁你可以 免费 拥有 这 支 手表 。
▁He ' s ▁gone ▁to ▁N ag oy a ▁on ▁business .	▁他去 名 古 屋 出 差 。
▁Do ▁you ▁know ▁where ▁he ▁lives ?	▁你知道 他 住在哪里 吗 ?
▁He ▁and ▁his ▁sisters ▁are ▁cur ren t ly ▁living ▁in ▁Tokyo .	▁他 和他的 姐妹 们 目前 都 住在 东京 。
▁I ▁received ▁a ▁letter ▁from ▁her .	▁我 收 到了 她的 来信 。
▁He ' s ▁often ▁mist aken ▁for ▁a ▁student .	▁他 常常 被 误 认为 是个 学生 。
▁Why ▁do ▁that ▁now ?	▁为什么 现在 做 那个 ?
▁This ▁is ▁a ▁low - b ud get ▁movie .	▁这是 一 部 低 成 本 的 电影 。
▁Don ' t ▁you ▁have ▁anything ▁to ▁eat ?	▁你们 有什么 不 吃 的吗 ?
▁A ▁capital ▁letter ▁is ▁used ▁at ▁the ▁begin ning ▁of ▁a ▁sentence .	▁一个 句子 以 一个大 写字 母 开始 。
▁She ▁said ▁that ▁she ▁gets ▁up ▁at ▁six ▁every ▁morning .	▁她 说她 每天早上 六点 起床 。
▁Mother ▁was ▁busy ▁getting ▁ready ▁for ▁dinner .	▁ 母亲 正 忙著 准备 晚餐 。
▁I ▁spend ▁time ▁on ▁Facebook ▁almost ▁every ▁day .	▁我 花了 几乎 一整天 在 用 Facebook 。
▁Where ' s ▁my ▁wife ?	▁我的 妻子 在哪里 ?
▁Why ▁are ▁you ▁being ▁so ▁secret ive ?	▁你为什么 这么 神 秘 ?
▁Would ▁you ▁mind ▁explain ing ▁this ?	▁你 愿意 解释 吗 ?
▁We ▁must ▁respect ▁other ▁people ' s ▁priv acy .	▁我们必须 尊 重 别人 的 私 隐 。
▁She ▁caught ▁cold s ▁often .	▁她 常常 感冒 。
▁He ▁always ▁mistakes ▁me ▁for ▁my ▁sister .	▁他 老 是 把我 和我 姐姐 搞 错 。
▁My ▁mother ▁was hes ▁clothes ▁every ▁day .	▁我妈妈 每天 洗 衣服 。
▁Sorry , ▁I ▁don ' t ▁have ▁any ▁money .	▁抱歉 , 我没 钱 。
▁Tom ▁wasn ' t ▁th irst y .	▁汤姆不 渴 。
▁There ' s ▁a ▁telephone ▁in ▁my ▁room .	▁我的 房间里 有一 支 电话 。
▁My ▁sister ▁is ▁twenty - one ▁years ▁old ▁and ▁a ▁college ▁student .	▁我妹妹 2 1 岁 , 是个 大 学生 。
▁I ▁remember ▁this ▁word .	▁我记得 这个 单 词 。
▁We ▁reached ▁the ▁top ▁of ▁the ▁mountain .	▁我们 到达 了 山 顶 。
▁I ▁think ▁Mary ▁is ▁very ▁att ract ive .	▁我认为 玛丽 很有 吸 引 力 。
▁I ' ll ▁come ▁as ▁often ▁as ▁possible .	▁我会 来 尽 可能 常 来 。
▁He ▁is ▁very ▁inf lu ent ial ▁in ▁the ▁world ▁of ▁medicine .	▁他在 医 学 界 有 很大的 影响 力 。
▁You ▁look ▁just ▁like ▁your ▁older ▁brother .	▁你看起来很 像 你的 哥哥 。
▁Do ▁you ▁have ▁medic al ▁ins ur ance ?	▁你有 医 疗 保 险 吗 ?
▁I ▁don ' t ▁need ▁anything .	▁我不 需要 任何东西 。
▁Tom ▁built ▁his ▁own ▁mot orc ycle .	▁汤姆 造 了他 自己的 摩 托车 。
▁You ' d ▁better ▁not ▁go ▁there ▁again .	▁你最好不要 再 去那里 。
▁We ' ll ▁ask ▁Tom ▁and ▁see ▁what ▁he ▁thinks .	▁我们要 问 问 汤姆 , 看看 他 怎么想 。
▁I ▁stayed ▁up ▁all ▁night ▁again .	▁我 又 熬 夜 了 。
▁We ' re ▁going ▁to ▁stay ▁in ▁Boston ▁all ▁month .	▁我们 整 个月 都 要 待 在波士顿 。
▁Tom ▁told ▁me ▁he ▁was ▁nervous .	▁汤姆告诉我他 紧张 。
▁This ▁book ▁is ▁full ▁of ▁mistakes .	▁这本书 充 满了 错误 。
▁Why ▁do ▁you ▁want ▁to ▁study ▁abroad ?	▁为什么 你想 到 外国 读书 ?
▁It ▁was ▁just ▁a ▁matter ▁of ▁time .	▁这 只是 时间 上的 问题 。
▁You ▁are ▁a ▁good ▁person .	▁你 是一个好 人 。
▁I ▁have ▁to ▁find ▁a ▁part - time ▁job .	▁我必须 找 一份 兼 职 工作 。
▁Tom ▁is ▁no ▁fool .	▁汤姆不 傻 。
▁I ▁don ' t ▁wish ▁to ▁har m ▁you .	▁我不想 伤害 你 。
▁He ▁wrote ▁a ▁letter .	▁他 写了一 封信 。
▁You ▁shouldn ' t ▁say ▁that ▁kind ▁of ▁thing ▁when ▁children ▁are ▁around .	▁孩子们 在 旁边 的时候 , 你不 应该 说 那种 事 。
▁Yesterday ▁was ▁my ▁birthday .	▁昨天 是我的 生日 。
▁Why ▁did ▁you ▁show ▁me ▁this ?	▁你为什么 让我 看 这个 ?
▁What ▁do ▁you ▁want ▁to ▁know ?	▁你想 知道 什么 ?
▁You ' re ▁never ▁satisfied ▁with ▁anything ▁I ▁do .	▁你 对我 做的 任何事 都不 满意 。
▁I ▁don ' t ▁know ▁what ▁you ' re ▁ref er ring ▁to .	▁我不知道 你 指 的 是什么 。
▁Are ▁you ▁Japanese ?	▁你是 日本 人吗 ?
▁Tom ' s ▁name ▁was ▁on ▁the ▁list .	▁汤姆的 名字 在 名 单上 。
▁A ▁st it ch ▁in ▁time ▁save s ▁nine .	▁小 洞 及时 补 , 免 遭 大 洞 苦 。
▁Who ▁taught ▁you ▁how ▁to ▁dance ?	▁谁 教 你 跳舞 的 ?
▁I ' m ▁not ▁quite ▁well .	▁我有 点 不舒服 。
▁V is it or s ▁to ▁Sw it z er land ▁adm ire ▁the ▁A lp s .	▁ 游 客 到 瑞 士 欣 赏 阿 尔 卑 斯 山 。
▁I ▁like ▁the ▁cold .	▁我喜欢 寒 冷 。
▁What ▁do ▁you ▁know ▁about ▁the ▁C I A ?	▁你知道 中 央 情 报 局 的 什么 ?
▁This ▁is ▁a ▁problem ▁you ▁have ▁to ▁solve ▁by ▁yourself .	▁这是一个 你必须 自己 解决 的问题 。
▁C le an ▁the ▁window ▁with ▁a ▁d am p ▁cl oth .	▁用 湿 布 清 洁 窗户 。
▁The ▁only ▁sound ▁to ▁be ▁heard ▁was ▁the ▁t ick ing ▁of ▁the ▁clock .	▁ 唯一 能 听到 的声音 是 钟 的 滴 答 声 。
▁He ' s ▁an ▁excellent ▁br ain ▁sur ge on .	▁他 是一个 优 秀 的 脑 外 科 医生 。
▁They ▁don ' t ▁pay ▁me ▁enough .	▁他们 给我 钱 没 给 够 。
▁Tom ▁and ▁Mary ▁own ▁a ▁small ▁or g an ic ▁far m .	▁汤姆和玛丽 拥 有一个 小 型 的 有 机 农 场 。
▁Tom ▁doesn ' t ▁like ▁to ▁wear ▁a ▁watch .	▁汤姆不喜欢 戴 手表 。
▁Where ▁does ▁she ▁want ▁to ▁go ?	▁她想 去哪里 ?
▁I ▁took ▁my ▁temper ature ▁every ▁six ▁hours .	▁我每 六 小时 量 一次 体 温 。
▁He ▁was ▁very ▁patient .	▁他非常 有 耐心 。
▁The ▁bill ▁passed ▁by ▁a ▁small ▁major ity ▁of ▁10 ▁v ot es .	▁ 法 案 以 10 票 微 弱 多 数 通过 。
▁I ▁wanted ▁to ▁surprise ▁her .	▁我想 给她 一个 惊 喜 。
▁Please ▁keep ▁this ▁secret .	▁请 保 守 这个 秘密 。
▁I ▁found ▁a ▁beautiful ▁she ll ▁on ▁the ▁sh ore .	▁我在 海滩 上 发现 了一个 漂亮的 贝 壳 。
▁I g n or ance ▁is ▁bl iss .	▁无 知 就是 幸福 。
▁He ▁may ▁be ▁on ▁the ▁next ▁train .	▁他可能 在 下一 班火车 上 。
▁Are ▁you ▁the ▁ow ner ▁of ▁this ▁house ?	▁你是 这 栋房子 的主 人吗 ?
▁She ▁quit ▁smoking .	▁她 停下来 抽烟 。
▁I ▁saw ▁him ▁looking ▁at ▁me .	▁我看见 他在 看 我 。
▁I ' m ▁sorry ▁I ▁didn ' t ▁rep ly ▁to ▁you ▁soon er .	▁抱歉 , 我没有 早点 回 复 你 。
▁I ' ve ▁got ▁to ▁try ▁to ▁find ▁Tom .	▁我 试图 找到 Tom 。
▁What ▁time ▁did ▁your ▁friend ▁go ▁home ?	▁你 朋友 几 点钟 回家 ?
▁I ▁want ▁to ▁drink ▁something ▁cold .	▁我想 喝点 冷饮 。
▁He ▁reg rets ▁his ▁having ▁was ted ▁his ▁money .	▁他 后悔 自己的 挥 金 如 土 。
▁I ' m ▁a ▁str anger ▁here .	▁我是 这里的 外 地 人 。
▁He ▁is ▁good ▁at ▁baseball .	▁他 垒 球 打 得很好 。
▁I ▁have ▁something ▁to ▁give ▁you .	▁我有 些 东西 要 给你 。
▁Thank ▁you ▁all ▁the ▁same .	▁ 同 样 感谢 你 。
▁I ▁tried ▁to ▁stop ▁that ▁from ▁happen ing .	▁我 试着 阻止 它 发生 。
▁How ▁often ▁do ▁you ▁see ▁him ?	▁您 多久 见 他 一次 ?
▁I ▁hid ▁under ▁the ▁table .	▁我 藏 在 桌子 底下 。
▁Turn ▁off ▁the ▁light , ▁please .	▁请 关灯 。
▁I ▁went ▁to ▁a ▁park ▁this ▁morning .	▁今天早上 我 去了 公园 。
▁Tom ▁finally ▁understood ▁it .	▁汤姆 最终 明白 了 。
▁Do ▁you ▁have ▁change ▁for ▁a ▁doll ar ?	▁你有 零钱 换 一 元 美 金 吗 ?
▁I ▁need ▁a ▁Japanese - E ngl ish ▁dictionary .	▁我需要 一本 日 英 字典 。
▁I ' ve ▁been ▁here ▁for ▁a ▁very ▁long ▁time .	▁我 在这里 很长 时间 了 。
▁I ▁bet ▁ten ▁dollars ▁on ▁that ▁horse .	▁我在 那 匹 马 下 十 美元 的 赌 注 。
▁What ▁do ▁you ▁say ▁to ▁taking ▁a ▁walk ▁in ▁the ▁park ?	▁去 公园 散步 你 觉得 怎么样 ?
▁I ▁was ▁un able ▁to ▁finish ▁my ▁homework .	▁我无法 完成 我的 作业 。
▁I ▁always ▁think ▁of ▁him ▁when ▁I ' m ▁alone .	▁我 孤 单 的时候 总 会 想起 他 。
▁The ▁E if fe l ▁T ower ▁is ▁in ▁the ▁same ▁city ▁as ▁the ▁L ou v re ▁M useum .	▁ 埃 菲 尔 铁 塔 和 卢 浮 宫 在 同 一 座 城市 。
▁They ▁seem ▁to ▁have ▁had ▁a ▁good ▁time ▁in ▁R ome .	▁他们 看来 在 罗马 过了 些 好 日 子 。
▁May ▁I ▁have ▁a ▁talk ▁with ▁you ?	▁我能 和你 谈谈 吗 ?
▁When ▁will ▁you ▁leave ?	▁你什么时候 离开 ?
▁Many ▁attend ed ▁his ▁fun er al .	▁很多 人都 参加 了他的 葬 礼 。
▁Al c oh ol ▁cons um pt ion ▁is ▁inc re as ing ▁every ▁year .	▁ 酒 的 消 费 每 年 都在 上 升 。
▁Tom ▁knows ▁I ▁want ▁to ▁leave ▁as ▁soon ▁as ▁possible .	▁汤姆知道 我想 尽 早 离开 。
▁We ▁have ▁plenty ▁of ▁time ▁to ▁sp are .	▁我们 还 剩 下 很多 时间 。
▁ Z im bab we ▁was ▁once ▁a ▁col ony ▁of ▁B rit ain .	▁ 津 巴 布 韦 曾经 是 英国 的 殖 民 地 。
▁I ▁conf ess ed ▁to ▁st eal ing ▁the ▁money .	▁我承认 偷了 钱 。
▁I ▁thought ▁Tom ▁had ▁a ▁soccer ▁game ▁tonight .	▁我以为 汤姆 今晚 有 足球 比赛 。
▁The ▁cur tain s ▁make ▁this ▁room ▁beautiful .	▁ 窗 帘 是 房间 变 漂亮 了 。
▁Let ' s ▁start !	▁让我们 开始吧 。
▁I ' ve ▁always ▁been ▁proud ▁of ▁you .	▁我一直 以 您 为 荣 。
▁Tom ▁was ▁very ▁scared .	▁汤姆 非常 害怕 。
▁The ▁pain ▁is ▁un b ear able .	▁ 疼 痛 令人 难以 忍受 。
▁Aren ' t ▁you ▁supposed ▁to ▁be ▁at ▁school ▁today ?	▁你今天 不是 应该 在 学校 的吗 ?
▁He ▁told ▁me ▁that ▁he ▁was ▁busy ▁then .	▁他 告诉我 他 那时 很忙 。
▁There ▁are ▁hol es ▁in ▁the ▁ce iling .	▁天 花 板 上有 洞 。
▁We ' re ▁not ▁stupid .	▁我们不 傻 。
▁I ▁know ▁the ▁problem .	▁我知道 问题 。
▁Tom ▁wanted ▁something ▁else .	▁汤姆 想要 别 的东西 。
▁She ▁doesn ' t ▁have ▁any ▁friends .	▁她 一个朋友 都没有 。
▁I ' m ▁a ▁he ro .	▁我是个 英 雄 。
▁Tom ▁came ▁back .	▁汤姆 回来了 。
▁E ach ▁year ▁H am am ats u ▁has ▁a ▁k ite ▁f est iv al .	▁每 年 滨 松 有 风筝 节 。
▁His ▁great est ▁fault ▁is ▁talking ▁too ▁much .	▁他 最大的 缺 点 就是 话 太多 。
▁We ▁talked ▁about ▁a ▁v ar iet y ▁of ▁top ics .	▁我们 谈 了 各 种 话 题 。
▁We ▁weren ' t ▁making ▁fun ▁of ▁you .	▁我们没有 笑话 你 。
▁They ▁live ▁across ▁the ▁river .	▁他们 住在 河 对面 。
▁I ▁stayed ▁up ▁late ▁last ▁night .	▁我昨晚 睡 得 晚 。
▁My ▁sister ▁often ▁c ries .	▁我妹妹 经常 哭 。
▁Do ▁you ▁think ▁they ▁not iced ?	▁你认为 他们 注意 了吗 ?
▁I ' ve ▁been ▁looking ▁for ▁my ▁trip od .	▁我一直 在 找 我的 三 脚 架 。
▁My ▁whole ▁family ' s ▁from ▁Boston .	▁我全 家 来自 波士顿 。
▁I ▁can ' t ▁believe ▁Tom ▁kiss ed ▁me .	▁我不 敢 相信 汤姆 亲 了我 。
▁Comp ared ▁with ▁yours , ▁my ▁car ▁is ▁small .	▁ 和 你的 车 比 起来 , 我的 车 很 小 。
▁It ▁is ▁high ▁time ▁you ▁were ▁in ▁bed .	▁你 早 该 睡了 。
▁Not ▁everyone ▁who ▁lives ▁here ▁is ▁rich .	▁ 并 不是 每个 住在这里 的人 都是 富有 的 。
▁I ▁made ▁up ▁my ▁mind ▁to ▁study ▁harder .	▁我决定 更 努力地 学习 。
▁I ▁have ▁to ▁explain ▁this ▁to ▁Tom .	▁我必须 向 Tom 解释 这个 。
▁This ▁shirt ▁cost s ▁ten ▁dollars .	▁这 衬衫 要 十 元 。
▁Un fort un ately , ▁it ▁rain ed .	▁很 遗憾 , 下雨了 。
▁I ▁carried ▁the ▁box ▁on ▁my ▁shoulder .	▁我把 盒子 扛 在 肩 上 。
▁She ▁can ' t ▁ride ▁a ▁bicycle ▁yet .	▁她 还 不会 骑 脚踏车 。
▁You ' d ▁better ▁cons ult ▁the ▁doctor .	▁你最好 请 教 一下 医生 。
▁My ▁eyes ight ▁is ▁getting ▁worse .	▁我的 视力 正 慢慢 下 降 。
▁She ▁has ▁changed ▁great ly ▁since ▁I ▁last ▁saw ▁her .	▁她 和 以前 比 起来 变 了很多
▁Tom ▁mo pped ▁the ▁floor .	▁汤姆 擦 了 地 板 。
▁She ▁saw ▁herself ▁in ▁the ▁mir ror .	▁她 看到 镜 子 里的 自己 。
▁Have ▁you ▁check ed ▁our ▁supp l ies ▁recently ?	▁你 最近 检查 我们的 补 给 了吗 ?
▁Let ▁me ▁introdu ce ▁myself .	▁请 允许 我 自 我 介绍 一下 。
▁I ▁had ▁difficulty ▁working ▁out ▁the ▁problem .	▁我在 解决这个问题 上有 困难 。
▁I ▁borrow ▁money .	▁我 借 钱 。
▁What ▁pre v ented ▁you ▁from ▁coming ▁earlier ?	▁为什么你 不能 早点 来 ?
▁Will ▁I ▁see ▁you ▁tomorrow ?	▁我明天 能 见到你 吗 ?
▁I ▁like ▁to ▁eat ▁apples .	▁我喜欢 吃 苹果 。
▁I ▁go ▁to ▁bed ▁late ▁at ▁night .	▁我 晚上 很晚 就 寝 。
▁She ▁must ▁still ▁be ▁in ▁her ▁tw ent ies .	▁她 一定 还 只是 二十 几岁 。
▁She ▁got ▁married ▁against ▁her ▁father ' s ▁will .	▁她 违 背 了她 父亲 的 意 愿 结 了 婚 。
▁We ▁ce le br ate ▁Christmas ▁every ▁year .	▁我们 每 年 都 庆 祝 圣诞节 。
▁The ▁storm ▁didn ' t ▁ab ate ▁for ▁several ▁hours .	▁风 暴 几个小时 没有 减 弱 了 。
▁I ' ll ▁get ▁you ▁some ▁coffee .	▁我会给你 带 些 咖啡 。
▁W hether ▁you ▁like ▁it ▁or ▁not ▁doesn ' t ▁matter .	▁你 喜 不喜欢 没关系 。
▁I ▁don ' t ▁feel ▁much ▁like ▁talking .	▁我不太 想 说话 。
▁I ' ll ▁come ▁to ▁your ▁place .	▁我会 来 你的 地方 。
▁I ▁paid ▁him ▁five ▁dollars .	▁我 付 了他 五 块 美元 。
▁You ▁could ▁run .	▁你能 跑 。
▁Sm oking ▁is ▁pro hib ited .	▁ 禁 止 吸烟 。
▁You ▁can ' t ▁count ▁on ▁their ▁help .	▁你不能 指望 他们的 帮助 。
▁That ▁wasn ' t ▁so ▁hard , ▁was ▁it ?	▁那 不 难 , 是 吧 ?
▁P r ide ▁goes ▁before ▁a ▁fall .	▁ 骄傲 使 人 落 后 。
▁I ▁waited ▁for ▁him ▁all ▁day ▁long .	▁我 等 了他 一整天 。
▁Water ▁is ▁ind is p ens able ▁to ▁life .	▁水 是 生命 所 不 可 缺 少 的 。
▁You ▁are ▁free ▁to ▁do ▁as ▁you ▁please ▁with ▁your ▁money .	▁你可以 随 你 高兴 的 用 你的 钱 。
▁I ' m ▁really ▁surprised ▁you ▁got ▁a ▁prize .	▁我很 惊讶 你 得了 奖 。
▁I ▁don ' t ▁know ▁what ▁we ' ll ▁do .	▁我不知道 我们 将会 做什么 。
▁It ▁was ▁Mar ie ▁C uri e ▁who ▁discovered ▁r ad i um .	▁ 镭 是 居 里 夫 人 所 发现 的 。
▁I ▁am ▁proud ▁of ▁my ▁father .	▁我 为我 父亲 而 自 豪 。
▁What ▁you ▁said ▁left ▁a ▁deep ▁impress ion ▁on ▁me .	▁你 说的话 给我 留 下了 很 深 刻 的 印象 。
▁As ▁he ▁spoke , ▁pictures ▁came ▁into ▁my ▁mind .	▁他说 的时候 , 我 脑 中 浮 现 出了 画 面 。
▁It ▁looks ▁like ▁today ▁will ▁be ▁a ▁long ▁day .	▁看来 今天 会 是 漫 长 的一天 啊 。
▁I ' ve ▁just ▁finished ▁eating ▁breakfast .	▁我刚 吃 完了 早饭 。
▁He ▁is ▁not ▁an ▁American .	▁他不是 美国人 。
▁Do ▁you ▁know ▁what ▁Tom ▁will ▁say ?	▁你知道 汤姆会 说 甚么 吗 ?
▁This ▁is ▁an ▁important ▁e vent .	▁这是个 重要 事 件 。
▁Do ▁you ▁know ▁when ▁she ▁will ▁come ?	▁你知道 她 什么时候 会来 吗 ?
▁Have ▁you ▁ever ▁seen ▁Tom ▁when ▁he ' s ▁angry ?	▁你有 看见 过 汤姆 生气 的时候 吗 ?
▁I ' ll ▁be ▁back ▁tomorrow .	▁我明天 回来 。
▁I ▁have ▁seen ▁the ▁f ilm ▁before .	▁我已经 看过 这 部电影 了 。
▁I ▁can ' t ▁do ▁anything ▁but ▁obey ▁him .	▁我 除了 听 从 他 之 外 什么 也 不能 做 。
▁Tom ▁went ▁home ▁alone .	▁汤姆 一个人 回家了 。
▁It ' s ▁hard ▁to ▁believe ▁that ▁Tom ▁wasn ' t ▁aw are ▁that ▁Mary ▁was ▁in ▁love ▁with ▁him .	▁真 难 相信 汤姆 不知道 玛丽 爱 他 。
▁They ▁fell ▁into ▁the ▁conversation ▁immediately .	▁他们 很快就 聊 起来了 。
▁I ▁will ▁never ▁forget ▁your ▁kind ness .	▁我永远不会 忘记 你的 亲 切 。
▁Sm oking ▁is ▁str ict ly ▁pro hib ited .	▁ 严 禁 吸烟 。
▁What ▁you ▁said ▁is ▁b al oney .	▁你 说 的东西 是 胡 扯 。
▁Look s ▁like ▁today ▁will ▁be ▁a ▁long ▁day .	▁看来 今天 会 是 漫 长 的一天 啊 。
▁She ▁came ▁here ▁as ▁soon ▁as ▁she ▁heard ▁it .	▁她一 来这里 就 听 到了 。
▁CD s ▁have ▁taken ▁the ▁place ▁of ▁rec ord s .	▁CD 已经 取 代 了 胶 木 唱 片 。
▁He ▁sc rap ed ▁the ▁m ud ▁off ▁his ▁bo ots .	▁他 刮 下 靴 子 上的 泥 巴 。
▁So cial ▁c ust om s ▁v ary ▁from ▁country ▁to ▁country .	▁ 国家 不同 , 习 俗 各 异 。
▁He ▁goes ▁to ▁school ▁on ▁foot .	▁他 步行 上学 。
▁Sp eech ▁is ▁sil ver , ▁but ▁sil ence ▁is ▁go ld en .	▁ 雄 辩 如 银 , 沉默 如 金 。
▁There ▁is ▁a ▁school ▁near ▁my ▁house .	▁我家 附近 有一 所 学校 。
▁That ▁would ▁be ▁unl ike ly .	▁那 不太 可能 。
▁I ' m ▁really ▁busy .	▁我真的 好 忙 。
▁We ▁talked ▁over ▁the ▁plan ▁with ▁him .	▁我们 和他 谈 了这个 计划 。
▁There ▁was ▁no ▁one ▁left ▁but ▁me .	▁除 了我 没有人 离开 。
▁S oon er ▁or ▁later ▁his ▁luck ▁will ▁run ▁out .	▁ 迟 早 他的 运 气 会 用 完 。
▁We ▁took ▁a ▁wrong ▁turn .	▁我们 拐 错 弯 了 。
▁I ▁ran ▁across ▁an ▁old ▁friend ▁near ▁the ▁bank .	▁我在 银行 附近 碰 见 老 朋友 。
▁This ▁is ▁the ▁window ▁he ▁broke .	▁他 砸 坏 的是 这 扇 窗 。
▁Wait er , ▁please ▁bring ▁me ▁some ▁water .	▁ 服务 生 , 请 给我 一些 水 。
▁She ▁married ▁him .	▁她 嫁 给 了他 。
▁Give ▁my ▁love ▁to ▁your ▁kids .	▁ 替 我 向 你的 孩子们 问 好 。
▁I ▁have ▁many ▁ab il ities .	▁我有 很多 才能 。
▁She ▁war ned ▁him ▁not ▁to ▁go ▁alone .	▁她 警告 了他 不要 一个人 去 。
▁There ▁is ▁a ▁ph oto ▁of ▁Tom ▁on ▁Mary ' s ▁desk .	▁在 玛丽的 桌 上有 张 汤姆的 照片 。
▁He ▁d ried ▁his ▁wet ▁clothes ▁by ▁the ▁fire .	▁他在 火 旁 烘 干 他的 湿 衣服 。
▁Don ' t ▁play ▁in ▁the ▁road .	▁别 在 马路 上 玩 。
▁That ' s ▁our ▁house .	▁那是 我们的 房子 。
▁All ▁the ▁flowers ▁in ▁the ▁garden ▁w it he red .	▁所有 花园 里的 花 朵 都 枯 萎 了 。
▁I ▁fed ▁the ▁dog .	▁我 喂 过 狗 了 。
▁He ▁has ▁made ▁a ▁for tune ▁through ▁hard ▁work .	▁他 通过 努力 挣 了 大 笔钱 。
▁She ▁spent ▁the ▁weekend ▁by ▁herself .	▁她 独自 度 过了 周末 。
▁They ▁will ▁get ▁married ▁next ▁month .	▁他们 将在 下个月 结婚 。
▁He ▁threw ▁a ▁piece ▁of ▁meat ▁to ▁a ▁dog .	▁他 朝 狗 扔 了一 块 肉 。
▁Let ' s ▁visit ▁some ▁temp les ▁tomorrow .	▁让我们 明天 参观 一些 寺 庙 。
▁I ' m ▁a ▁c it iz en ▁of ▁the ▁world .	▁我是 世界 公 民 。
▁The ▁exper im ent ▁was ▁success ful .	▁这 实 验 是 成功的 。
▁I ▁will ▁obey .	▁我会 听 从 指 示 。
▁He ▁likes ▁to ▁build ▁mod el ▁plan es .	▁他喜欢 建 造 模 型 飞机 。
▁I ▁am ▁a ▁student ▁of ▁this ▁school .	▁我是 这个 学校 的学生 。
▁I ▁know ▁that ▁money ▁isn ' t ▁everything .	▁我知道 金钱 不 代表 一切 。
▁Don ' t ▁forget ▁smoking ▁is ▁bad ▁for ▁your ▁health .	▁不要 忘记 吸烟 对你的 健康 有 害 。
▁Al most ▁no ▁one ▁believe s ▁her .	▁几乎 没人 相信 她 。
▁Ask ▁Tom .	▁去 问 汤姆 。
▁She ▁dis l i k ed ▁her ▁husband .	▁她不喜欢 她的 丈夫 。
▁Tom ▁lives ▁three ▁mil es ▁e ast ▁of ▁here .	▁汤姆 在这 以 东 三 哩 的地方 住 。
▁Bring ▁me ▁today ' s ▁paper , ▁please .	▁请帮我 把 今天 的 报纸 带来 。
▁I ▁didn ' t ▁mean ▁that .	▁我没有 那个 意思 。
▁Do ▁you ▁know ▁who ▁they ▁are ?	▁你知道 他们 是谁 吗 ?
▁We ' re ▁on ▁st ri ke ▁because ▁the ▁company ▁hasn ' t ▁impro ved ▁our ▁w ages .	▁我们 之 所以 罢 工 是因为 公司 没有 改 善 我们的 工 资 。
▁I ▁got ▁a ▁f are w ell ▁present ▁from ▁everyone .	▁每个人都 送 了我 一份 欢 送 礼物 。
▁The ▁problem ▁was ▁very ▁difficult .	▁这个 问题 非常 困难 。
▁I ' ll ▁sc old ▁him .	▁我会 责 备 他 。
▁Ask ▁her ▁when ▁she ▁comes ▁back .	▁等 她 回来 的时候 问 问 她 。
▁She ▁is ▁drunk ▁with ▁happ iness .	▁她 陶 醉 在 幸福 里 。
▁Be ▁real ist ic .	▁ 现 实 点 !
▁Put ▁your ▁we ap on ▁down .	▁把你的 武 器 放 下 。
▁I ' m ▁almost ▁finished ▁reading ▁this ▁book .	▁我 就要 读完 这本书 了 。
▁This ▁problem ▁is ▁too ▁difficult ▁for ▁pr im ary ▁school ▁children ▁to ▁solve .	▁这个 问题 让 小 学生 解决 太 难 了 。
▁He ▁post p oned ▁leaving ▁for ▁Hokkaido ▁until ▁next ▁month .	▁他 延 迟到 下个月 去 北海道 。
▁The ▁law ▁is ▁quite ▁clear .	▁ 法律 很 清楚 。
▁Have ▁you ▁finished ▁reading ▁that ▁book ?	▁你 读完 那 本书 了吗 ?
▁I ▁let ▁my ▁sister ▁use ▁my ▁new ▁computer .	▁我 让我 妹妹 用我的 新 电脑 。
▁How ▁much ▁is ▁this ?	▁这是 多少 ?
▁Don ' t ▁worry .	▁别 担心 。
▁Mar ri age ▁is ▁the ▁m ain ▁cause ▁of ▁divor ce .	▁ 婚 姻 是 造 成 离婚 的主 因 。
▁She ▁was ▁pleas ed ▁with ▁the ▁new ▁dress .	▁那 条新裙子 让她 很 满意 。
▁I ▁che ered ▁myself ▁up ▁by ▁listening ▁to ▁music .	▁我 借 由 听音乐 来 鼓 舞 我 自己 。
▁Tom ▁y a wn ed .	▁汤姆 打 哈 欠 了 。
▁D e ce mber ▁has ▁thirty - one ▁days .	▁十 二 月 有 三十 一天 。
▁What ▁do ▁you ▁think ▁of ▁it ?	▁你认为 如何 ?
▁He ▁is ▁ind ep end ent ▁of ▁his ▁parents .	▁他 独 立 于 他的 父母 。
▁Which ▁book ▁is ▁better ?	▁哪 一本书 比较 好 ?
▁We ' ve ▁never ▁had ▁this ▁problem ▁before .	▁我们 从 前 从 没有 过 这个问题 。
▁The ▁val ue ▁of ▁the ▁painting ▁was ▁ est im ated ▁at ▁several ▁million ▁dollars .	▁这 幅画 被 估 价 数 百 万 元 。
▁I ▁really ▁have ▁to ▁be ▁going .	▁我真的 得 走了 。
▁I ▁love ▁drinking ▁tea .	▁我很 爱 喝 茶 。
▁Tom ▁can ' t ▁swim .	▁汤姆不会 游泳 。
▁A d d ▁a ▁t in y ▁p in ch ▁of ▁salt .	▁ 加 一 丁 点 盐 。
▁I ▁like ▁j az z .	▁我喜欢 爵 士 乐 。
▁I ▁don ' t ▁trust ▁him ▁any ▁more .	▁我不 再 相信 他了 。
▁We ▁need ▁to ▁make ▁a ▁plan .	▁我们需要 做 计划 。
▁I ▁wish ▁we ▁had ▁won ▁the ▁game .	▁但愿 我们 赢 了这 场 比赛 就好了 。
▁Tell ▁them ▁we ' re ▁coming .	▁ 告诉 他们 我们 要 来了 。
▁You ▁are ▁not ▁author ized ▁to ▁enter ▁there .	▁你 无 权 进入 那里 。
▁What ▁will ▁tomorrow ' s ▁weather ▁be ▁like ?	▁明天 天气 怎么样 ?
▁Have ▁you ▁given ▁Tom ▁everything ?	▁你 全都 给汤姆 了吗 ?
▁He ▁used ▁to ▁be ▁an ▁imag in ative ▁boy .	▁他 曾经 是一个 富有 想 像 力 的男孩 。
▁The ▁bo ard ▁un an im ous ly ▁decided ▁to ▁app oint ▁her ▁as ▁C E O .	▁ 董 事 会 一 致 决定 任 命 她 为 执 行 总 裁 。
▁Take ▁wh ic he ver ▁you ▁want .	▁ 拿 你想要 的 。
▁I ▁was ▁born ▁on ▁O ct ob er ▁10 th , ▁19 7 2 .	▁我 出生 于 19 7 2 年 10 月 10 日 。
▁Tom ▁bought ▁new ▁gl ove s .	▁汤姆 买了 新 手 套 。
▁No ▁one ▁man ▁could ▁do ▁it .	▁没有 一个人 能 做到 这 一点 。
▁Tom ▁passed ▁away ▁on ▁O ct ob er ▁20 , ▁20 1 3 .	▁汤姆 逝 世 于 20 1 3 年 10 月 20 日 。
▁E arth qu akes ▁f re qu ently ▁hit ▁Japan .	▁ 地震 频 繁 地 袭 击 日本 。
▁Come ▁if ▁you ▁can .	▁如果你 能 就 来 吧 。
▁You ▁swim ▁better ▁than ▁me .	▁你 游泳 游得 比我 好 。
▁I ' ll ▁glad ly ▁pay ▁you ▁any time .	▁我 随时 乐 意 付钱 给你 。
▁He ▁did ▁not ▁answer ▁the ▁phone , ▁so ▁I ▁sent ▁him ▁an ▁em ail .	▁他没有 接 电话 , 所以我 给他 发 了 封 邮 件 。
▁You ▁should ▁be ▁good ▁to ▁your ▁neighbor s .	▁你应该 对 邻居 好 点 。
▁Take ▁as ▁many ▁pe ac hes ▁as ▁you ▁like .	▁你想 拿 多少 桃 子 就 拿 多少 。
▁He ▁lost ▁a ▁book .	▁他 弄 丢 了一 本书 。
▁Tom ▁was ▁rep l aced ▁by ▁Mary .	▁汤姆被 玛丽 替 换 下来 。
▁It ' s ▁no ▁use ▁arg u ing ▁about ▁it .	▁ 争 论 是 它是 没有 用的 。
▁There ▁is ▁no ▁den ying ▁the ▁fact .	▁这是 无 可 否认 的事 实 。
▁Every ▁cloud ▁has ▁a ▁sil ver ▁l in ing .	▁每 朵 云 都 披 著 银 衣 。
▁She ▁made ▁a ▁lot ▁of ▁spe ll ing ▁mistakes .	▁她 犯 了很多 拼 写 错误 。
▁Tom ▁w ished ▁he ▁had n ' t ▁borrowed ▁the ▁book ▁from ▁Mary .	▁汤姆 希望 他 没有 从 玛丽 那里 借 书 。
▁Are ▁they ▁all ▁the ▁same ?	▁他们 都是 一样 的吗 ?
▁Tom ▁is ▁in ▁the ▁att ic .	▁汤姆在 阁 楼 里 。
▁The ▁weather man ▁says ▁there ▁is ▁a ▁storm ▁on ▁the ▁way .	▁ 气 象 学 家 说 会有 暴风 雨 。
▁Do ▁you ▁think ▁he ▁did ▁the ▁job ▁on ▁his ▁own ?	▁你认为 他是 自己 独 立 完成 这 份 工 的吗 ?
▁As ▁long ▁as ▁you ' re ▁here , ▁I ' ll ▁stay .	▁只要 你 在这儿 , 我就 会 留 下来 。
▁Tom ' s ▁the ▁only ▁guy ▁in ▁this ▁class .	▁汤姆是 这个 班 级 里 唯一 的 男生 。
▁When ▁he ▁shout ed , ▁the ▁ve ins ▁in ▁his ▁ne ck ▁st ood ▁out ▁clearly .	▁当 他 咆 哮 时 , 他 脖 子 上 青 筋 暴 起 。
▁I ' ve ▁caught ▁a ▁terri ble ▁cold .	▁我得 了一 种 可怕 的 感冒 。
▁His ▁int ell ig ence ▁and ▁experience ▁en ab led ▁him ▁to ▁deal ▁with ▁the ▁trouble .	▁他的 智 慧 和 经验 使 他能 处理 这个 麻烦 。
▁Tom ▁felt ▁hungry .	▁汤姆 觉得 饿了 。
▁Can ▁I ▁have ▁a ▁b ite ?	▁我可以 吃 一 口 吗 ?
▁I ▁think ▁she ▁will ▁divor ce ▁him .	▁我想 她 会 和他 离婚 。
▁I ▁got ▁on ▁the ▁wrong ▁train .	▁我上 错了 火车 。
▁How ▁did ▁you ▁make ▁this ▁soup ?	▁这 汤 怎么 做的 ?
▁Would ▁you ▁lend ▁me ▁your ▁dictionary ?	▁你可以 借我 你的 字典 吗 ?
▁You ▁run .	▁你 跑 。
▁Is ▁this ▁everything ?	▁这 就是 全部 吗 ?
▁I ▁agree .	▁我同意 。
▁How ▁long ▁do ▁you ▁plan ▁to ▁stay ?	▁你 准备 待多久 ?
▁T alk ing ▁during ▁a ▁concert ▁is ▁rude .	▁在 音乐会 中 说话 是不 礼貌 的 。
▁The ▁earth ▁is ▁sim il ar ▁to ▁an ▁orange ▁in ▁sha pe .	▁ 地球 的 外 形 和 橙子 相 似 。
▁This ▁is ▁a ▁w ig .	▁这是 假 发 。
▁Tom ▁won ' t ▁let ▁you ▁in ▁his ▁house .	▁汤姆不会 让你 进 他的 屋 子 。
▁It ' s ▁much ▁more ▁con ven ient .	▁这 方便 得多 了 。
▁I ' m ▁as ▁tall ▁as ▁you .	▁我 跟你 一样高 。
▁You ' re ▁making ▁progress .	▁你在 进步 。
▁I ▁go ▁to ▁bed ▁at ▁eleven .	▁我 十 一点 上床 。
▁She ▁d ust s ▁the ▁furniture ▁every ▁day .	▁她 每天 擦 拭 家具 的 灰 尘 。
▁I ▁am ▁going ▁to ▁play ▁tennis ▁tomorrow .	▁我明天 会去 打网球 。
▁What ▁do ▁I ▁have ▁to ▁do ▁now ▁that ▁I ' m ▁reg ist ered ?	▁我 注 册 了 , 现在 该 干什么 呢 ?
▁We ▁had ▁a ▁good ▁time ▁playing ▁che ss .	▁我们 下 棋 玩得很开心 。
▁The ▁French ▁R e v olut ion ▁began ▁in ▁1 7 89 .	▁ 法国 大 革 命 1 7 89 年 开始 。
▁You ▁made ▁a ▁w ise ▁choice .	▁你 做了一个 明 智 的 选择 。
▁I ' m ▁still ▁p u z z led .	▁我还 不 明白 。
▁Do ▁you ▁believe ▁me ?	▁你相信 我吗 ?
▁I ▁don ' t ▁have ▁a ▁computer .	▁我没有 电脑 。
▁My ▁car ▁broke ▁down ▁this ▁morning ▁and ▁won ' t ▁be ▁repaired ▁until ▁Fr iday .	▁我的 车 今天 早上 坏了 , 星期 五 才能 修 好 。
▁What ▁is ▁learned ▁in ▁the ▁cr ad le ▁is ▁carried ▁to ▁the ▁to mb .	▁ 幼 年 时 学 的东西 , 一 辈 子 不会 忘记 。
▁When ▁will ▁we ▁go ?	▁我们 甚么时候 出发 ?
▁That ▁medicine ▁isn ' t ▁going ▁to ▁help .	▁那 药 不会 管 用 。
▁Thanks ▁for ▁ret ur ning ▁my ▁call .	▁ 感谢 您的 回 电 。
▁I ▁do ▁not ▁like ▁science .	▁我不喜欢 科学 。
▁That ▁boy ▁den ies ▁st eal ing ▁the ▁bicycle .	▁那个 男孩 否认 偷了 自行车 。
▁A ▁b urg lar ▁broke ▁into ▁his ▁house .	▁一个 窃 贼 闯 进 了他的 房子 。
▁At ▁lunch time ▁today , ▁our ▁us ual ▁restaurant ▁was ▁closed ▁because ▁of ▁a ▁fun er al ▁in ▁the ▁family .	▁今天 午餐 时间 , 我们 常 去 的 饭 馆 关门 了 , 因为 他们 家 在 办 丧 事 。
▁What ' s ▁the ▁weather ▁like ▁today ?	▁今天 天气 怎么样 ?
▁" W h o ▁is ▁in ▁the ▁car ?" ▁" Tom ▁is ."	▁“ 谁 在 车 里 ?” ▁“ 汤姆 。”
▁You ' re ▁still ▁green .	▁你还 年轻 。
▁The ▁young ▁man ▁is ▁a ▁doctor .	▁这个 年轻人 是 医生 。
▁I ▁studied ▁English , ▁French ▁and ▁Chinese .	▁我从 前 学习 英文 、 德 文 和 中文 。
▁After ▁school , ▁I ▁go ▁to ▁an ▁English ▁school ▁to ▁pract ice ▁English ▁conversation .	▁ 放学后 , 我 到 一 所 英语 学校 去 练习 英语 会 话 。
▁Your ▁answer ▁is ▁wrong .	▁你的 回答 是 错的 。
▁S al t ▁help s ▁to ▁pres erve ▁food ▁from ▁dec ay .	▁ 盐 可以 帮助 保 存 食物 避免 腐 烂 。
▁It ' s ▁o k ay ▁to ▁go .	▁你可以 走了 。
▁That ▁was ▁all ▁G ree k ▁to ▁me .	▁我完全 看 不懂 。
▁What ▁time ▁do ▁you ▁wake ▁up ▁on ▁Sundays ?	▁你 星期天 几点 起床 ?
▁You ▁have ▁to ▁get ▁this ▁work ▁finished ▁by ▁noon .	▁你必须 在 中午 以前 完成 这个工作 。
▁The ▁novel ▁end s ▁with ▁the ▁he ro ine ' s ▁death .	▁ 小说 以 女 主 角 的 死 告 终 。
▁We ▁enjoyed ▁watching ▁the ▁TV .	▁我们喜欢 看电视 。
▁I ▁don ' t ▁think ▁I ▁like ▁this ▁game ▁very ▁much .	▁我觉得 我不 太 喜欢 这 游戏 。
▁It ▁is ▁easy ▁to ▁answer ▁the ▁question .	▁这个 问题 很容易 回答 。
▁I ▁miss ▁you . ▁I ▁need ▁to ▁see ▁you . ▁Could ▁I ▁come ▁over ?	▁我想你 。 我 需要 见你 。 我能 来吗 ?
▁They ▁are ▁j ealous ▁of ▁our ▁success .	▁她 们 嫉妒 我们的 成功 。
▁Why ▁didn ' t ▁you ▁lock ▁the ▁door ?	▁你为甚么 不 锁门 ?
▁I ' ll ▁show ▁you ▁to ▁the ▁station .	▁我会 告诉你 去 车站 的路 。
▁O h ▁no !	▁ 不会 吧 。
▁Open ▁the ▁box .	▁ 打开 箱子 。
▁He ▁taught ▁himself ▁French .	▁他 自 学法语 。
▁Who ▁are ▁we ?	▁我们 是谁 ?
▁I ▁can ' t ▁do ▁it .	▁我无法 做到 这 一点 。
▁Tom ▁has ▁only ▁a ▁week ▁to ▁decide .	▁汤姆 只 有一 周 时间 做 决定 。
▁Is ▁that ▁love ?	▁那是 爱 吗 ?
▁She ▁is ▁wearing ▁a ▁hat .	▁她 戴 著 一 顶帽子 。
▁What ' s ▁new ?	▁有 什么 新鲜 事 吗 ?
▁You ▁don ' t ▁know ▁how ▁worried ▁I ▁am .	▁你不 知道 我 有多 担心 啊 。
▁I ▁want ▁to ▁get ▁rid ▁of ▁it .	▁我想 摆 脱 它 。
▁We ▁went ▁swimming ▁at ▁the ▁beach .	▁我们 去 海 边 游泳 。
▁Tom ▁over s lept .	▁汤姆 睡 过 头 了 。
▁U k r ain ian ▁girls ▁are ▁the ▁pret t i est ▁in ▁the ▁world .	▁ 乌 克 兰 姑 娘 是 全 世界 最 漂亮的 姑 娘 。
▁The ▁bill ▁will ▁never ▁go ▁through .	▁该 法 案 将 永远不会 通过 。
▁Tom ▁has ▁a ▁large ▁j ar ▁of ▁pen n ies .	▁汤姆 有一 大 罐 零钱 。
▁Good ▁luck . ▁You ' ll ▁need ▁it .	▁祝 你 好运 。 你会 需要 它 。
▁I ▁asked ▁for ▁a ▁table ▁over ▁there .	▁我在 那里 要 了一 张 桌子 。
▁He ▁can ' t ▁seem ▁to ▁understand ▁that ▁po em .	▁他 似乎 无法 理解 那 首 诗 。
▁The ▁gr ass ▁looks ▁nice .	▁ 草 地 看来 不错 。
▁You ' re ▁not ▁a ▁doctor .	▁您 不是 医生 。
▁This ▁is ▁my ▁prop er ty .	▁这是我的 财 产 。
▁Watch ▁my ▁camera ▁for ▁me .	▁ 帮我 看著 我的 相机 。
▁Does ▁he ▁speak ▁English ?	▁他 说英语 吗 ?
▁The ▁econom y ▁of ▁the ▁is land ▁is ▁depend ent ▁on ▁the ▁fishing ▁ind ust ry .	▁这个 岛 的 经济 依靠 的是 渔 业 。
▁I ▁received ▁her ▁letter ▁yesterday .	▁昨天我 收 到了 她的 信 。
▁I ▁used ▁to ▁eat ▁like ▁a ▁p ig .	▁我 曾经 像 猪 一样 吃 。
▁It ▁wasn ' t ▁me ▁who ▁told ▁you ▁not ▁to ▁do ▁that .	▁不是 我 告诉你 不要 去 做的 。
▁His ▁parents ▁ran ▁a ▁hotel .	▁他的 父母 经 营 一家 酒店 。
▁Tom ▁wanted ▁to ▁see ▁Mary .	▁汤姆想 见 玛丽 。
▁I ▁app re ciate ▁your ▁concer n .	▁我 感谢 你的 关心 。
▁They ▁are ▁trying ▁to ▁keep ▁cost s ▁down .	▁他们 正 努力 降 低 成 本 。
▁What ▁does ▁he ▁want ▁to ▁do ?	▁他 到底 想 干 嘛 ?
▁You ▁don ' t ▁understand ▁the ▁pro ced ure .	▁你不 明白 程 序 。
▁It ' s ▁great .	▁ 真是 太好了 。
▁That ' s ▁my ▁younger ▁sister ' s ▁phot ograph .	▁那是我 妹妹 的照片 。
▁Can ' t ▁you ▁speak ▁English ?	▁你 不会 说英语 吗 ?
▁Where ver ▁you ▁go , ▁I ▁will ▁follow .	▁无论 你 去哪里 我都会 跟著 你 。
▁There ▁were ▁risk s .	▁有 风 险 。
▁You ▁seem ▁to ▁know ▁everything .	▁你看起来 什么都 知道 。
▁I ▁feel ▁like ▁taking ▁a ▁bath ▁now .	▁我现在 想 洗澡 。
▁You ▁should ▁have ▁done ▁so .	▁你本 应该 这样 做的 。
▁How ▁was ▁the ▁meeting ▁yesterday ?	▁昨天 的 会议 怎么样 ?
▁She ▁gave ▁him ▁a ▁t end er ▁kiss .	▁她给 了他 一个 温 柔 的 吻 。
▁There ▁were ▁several ▁room s ▁still ▁vac ant .	▁ 还有 几 间 空 房 。
▁Everyone ▁was ▁fine .	▁大家都 还 行 。
▁Both ▁of ▁my ▁sisters ▁are ▁married .	▁我的 两个 姐妹 都 结婚了 。
▁I ▁don ' t ▁believe ▁you . ▁You ' re ▁always ▁telling ▁li es .	▁我不 相信你 。 你 总是 说谎 。
▁He ▁walked ▁in ▁the ▁park ▁yesterday .	▁他昨天 在 公园里 散步 。
▁We ' ll ▁be ▁busy .	▁我们 会 很忙 。
▁She ▁was ▁vis ib ly ▁afraid ▁to ▁be ▁here .	▁ 显然 她 害怕 待在这里 。
▁There ▁used ▁to ▁be ▁a ▁bridge ▁here .	▁ 以前 这里 有一 座桥 。
▁I ▁was ▁just ▁about ▁to ▁leave .	▁我 就要 离开了 。
▁His ▁abs ence ▁gave ▁birth ▁to ▁all ▁s orts ▁of ▁r umor s .	▁他的 缺 席 导 致 了 各 种 谣 言 的 产 生 。
▁We ▁studied ▁English .	▁我们 学了 英语 。
▁I ▁won ' t ▁work ▁over time ▁today .	▁今天 我不 加 班 。
▁Let ' s ▁take ▁the ▁bus .	▁让我们 坐 公共 汽车 去 。
▁You ▁look ▁just ▁like ▁Tom .	▁你看起来 就像 汤姆 。
▁How ▁can ▁I ▁reach ▁you ?	▁我 怎么 联系 你 ?
▁Do ▁you ▁keep ▁in ▁cont act ▁with ▁your ▁high ▁school ▁classm ates ?	▁你还 和 你的 高中 同学 保持 联系 吗 ?
▁The ▁sky ▁was ▁completely ▁dark .	▁天空 完全 变 黑 了 。
▁If ▁you ▁don ' t ▁want ▁to ▁go , ▁you ▁don ' t ▁need ▁to .	▁如果你 不想去 , ▁就 不必 去了 。
▁Tom ▁should ' ve ▁already ▁discuss ed ▁that ▁with ▁you .	▁汤姆应该 已经 跟你 讨论 过 那事 了 。
▁I ▁don ' t ▁feel ▁like ▁eating ▁sushi .	▁我不想 吃 寿司 。
▁Y es , ▁of ▁course .	▁是 的 , 当然 。
▁Let ▁them ▁decide .	▁让 他们 决定 。
▁The ▁sky ▁is ▁clear .	▁天空 很 晴 朗 。
▁Have ▁you ▁finished ▁your ▁homework ?	▁你 做完 作业 了吗 ?
▁G rab ▁Tom .	▁ 抓住 汤姆 。
▁He ▁sold ▁his ▁business ▁and ▁ret ired .	▁他 卖 掉 了他的 事 业 并且 退休 。
▁Tom ▁has ▁no ▁friends ▁to ▁play ▁with .	▁汤姆没有 朋友 可以 一起 玩 耍 。
▁We ▁have ▁less ▁than ▁five ▁minutes ▁to ▁ev ac u ate ▁the ▁whole ▁building .	▁我们有 不到 五 分钟 来 疏 散 整 栋 楼 的人 。
▁I ▁think ▁he ▁won ' t ▁come .	▁我认为 他 不会来 。
▁A ▁foreign ▁language ▁can ' t ▁be ▁m ast ered ▁in ▁a ▁year ▁or ▁so .	▁一个 外国 语言 无法 在 一年 左右 就 被 掌 握 。
▁She ▁has ▁been ▁absent ▁since ▁last ▁W ed n es day .	▁从 上 周 三 起 , 她 一直 缺 席 。
▁Are ▁you ▁lost ?	▁您 迷路 了吗 ?
▁What ▁do ▁you ▁want ▁now ?	▁您 现在 想要 什么 ?
▁I ' m ▁hop ing ▁that ' ll ▁happen .	▁我希望 那 会发生 。
▁I ▁don ' t ▁want ▁something ▁like ▁this ▁to ▁happen .	▁我不想 这种 事 发生 。
▁What ▁will ▁you ▁use ▁it ▁for ?	▁你会 用 它 来 做什么 ?
▁The ▁m ain ▁problem ▁with ▁Tom ▁is ▁that ▁he ▁has ▁no ▁sense ▁of ▁hum or .	▁汤姆的 主 要 问题 是他 一点 幽 默 感 都没有
▁I ' ll ▁come ▁back .	▁我会 回来的 。
▁Don ' t ▁worry . ▁You ' ll ▁make ▁it .	▁不要 担心 。 你 办 得到 的 。
▁Where ' s ▁the ▁nearest ▁train ▁station ?	▁最近的 火车站 在哪里 ?
▁I ' m ▁the ▁one ▁who ▁has ▁to ▁do ▁this .	▁我是 必须 去做 这事 的人 。
▁Take ▁this ▁medicine ▁every ▁six ▁hours .	▁每 六 个 小时 吃 一次 这个 药 。
▁Who ▁is ▁your ▁teacher ?	▁谁 是你 老师 ?
▁I ▁spent ▁my ▁vacation ▁at ▁the ▁beach .	▁我在 海 边 度假 。
▁Does n ' t ▁that ▁change ▁things ?	▁那 能 改变 甚么 吗 ?
▁She ▁felt ▁in se c ure ▁about ▁her ▁future .	▁她对 她的 未 来 感到 没有 安全 感 。
▁Take ▁the ▁first ▁street ▁to ▁the ▁right .	▁ 第 一条 街 右 转 。
▁We ▁had ▁to ▁go ▁there ▁together .	▁我们必须 一起去 。
▁Who ▁will ▁take ▁care ▁of ▁the ▁dog ▁while ▁we ▁are ▁away ?	▁当 我们 离开 的时候 , 谁 来 照顾 狗 ?
▁Write ▁your ▁name ▁in ▁capital ▁letters .	▁ 写 下 你 名字 的 大 写字 母 。
▁The ▁show ▁was ▁very ▁interesting . ▁You ▁should ▁have ▁seen ▁it .	▁ 演 出 真的 很有意思 , 你 该 去 看看 的 。
▁I ▁heard ▁a ▁knock ▁at ▁the ▁door .	▁我听 到了 敲门 声 。
▁The ▁girl ▁was ▁so b b ing ▁in ▁the ▁corner ▁of ▁the ▁school room .	▁ 女孩 在 教室 的 角 落 啜 泣 。
▁Come ▁along ▁with ▁me .	▁请 跟我 来 。
▁There ▁are ▁only ▁three ▁women ▁in ▁this ▁class .	▁这个 班 只 有 三个 女 生 。
▁Please ▁show ▁me ▁your ▁bag .	▁请让我 看看 你的 袋子 。
▁You ▁lied ▁to ▁me , ▁didn ' t ▁you ?	▁你 对我 说了 谎 , ▁没有 吗 ?
▁We ▁know ▁what ▁we ' re ▁doing .	▁我们 知道 我们 在做什么 。
▁It ▁depends ▁on ▁the ▁cont e xt .	▁这 要 看 情况 。
▁I ▁tried ▁to ▁change ▁her ▁mind , ▁but ▁I ▁couldn ' t .	▁我 试著 改变 她的 心 意 , 但我 没有 办法 。
▁Please ▁say ▁it ▁more ▁loud ly .	▁请 说 更 大声 一点 。
▁Do ▁you ▁think ▁Tom ▁will ▁show ▁up ?	▁你认为 汤姆会 出现 吗 ?
▁She ' s ▁my ▁older ▁sister .	▁她 是我的 姐姐 。
▁L ist en ▁to ▁me , ▁OK ?	▁听 我 说 , 好吗 ?
▁You ▁may ▁choose ▁any ▁book ▁you ▁like .	▁你可以 选择 任何 你喜欢 的书 。
▁I ▁can ▁come ▁at ▁three .	▁我 三 点钟 可以 来 。
▁He ▁drives ▁his ▁own ▁car .	▁他 开 他 自己的 车 。
▁I ▁couldn ' t ▁understand ▁anything ▁that ▁he ▁said .	▁我不 了解 他 所 说 的事情 。
▁No ▁problem ▁at ▁all !	▁ 一点 问题 都没有 !
▁We ▁help ▁the ▁poor .	▁我们 帮助 穷 人 。
▁He ▁has ▁been ▁to ▁H aw ai i ▁several ▁times .	▁他 去过 夏 威 夷 几 次 。
▁Does ▁Tom ▁still ▁like ▁j az z ?	▁汤姆 还 喜欢 爵 士 乐 吗 ?
▁The ▁door ▁was ▁k ick ed ▁open .	▁ 门 被 踢 开 了 。
▁This ▁makes ▁me ▁very ▁angry .	▁这 让我 很 生气 。
▁Our ▁country ▁must ▁de vel op ▁its ▁n atur al ▁res our ces .	▁我们 国家 必须 开 发 自然 资 源 。
▁I ▁don ' t ▁mind ▁if ▁I ▁get ▁wet .	▁我不 介意 被 弄 湿 。
▁His ▁father ▁doesn ' t ▁play ▁golf .	▁他 父亲 不 打高尔夫球 。
▁I ▁cannot ▁afford ▁to ▁pay ▁so ▁much .	▁我 付 不起 这么多 钱 。
▁Tom ▁got ▁f at .	▁汤姆 变 胖 了 。
▁There ▁is ▁a ▁large ▁supermarket .	▁有 一个大 型 超市 。
▁You ▁should ▁ask ▁your ▁father ▁for ▁his ▁advice ▁and ▁follow ▁it .	▁你应该 问你 父亲 的 忠告 并 遵守 它 。
▁This ▁is ▁my ▁bicycle .	▁这是我的 自行车 。
▁It ' s ▁already ▁nine ▁o ' clock .	▁已经 9 点了 。
▁I ▁listen ed ▁to ▁some ▁rec ord s ▁last ▁night .	▁我昨晚 听 了一些 唱 片 。
▁Hey , ▁you ! ▁What ▁are ▁you ▁doing ?	▁ 嘿 , 你 ! 你 在 干什么 ?
▁I ' ll ▁study ▁your ▁report .	▁我会 研究 你的 报告 。
▁I ▁must ▁go ▁now .	▁我现在 必须 走了 。
▁May ▁I ▁come ▁and ▁see ▁you ▁tomorrow ?	▁我明天 可以 来看 你 吗 ?
▁Children ▁should ▁keep ▁away ▁from ▁the ▁river . ▁It ' s ▁dangerous .	▁ 儿童 应该 远 离 河 流 。 有 危险 。
▁I ▁want ▁to ▁clean ▁the ▁house ▁before ▁my ▁parents ▁come .	▁我想 在 我 父母 来 之前 收 拾 干净 屋 子 。
▁Don ' t ▁m ention ▁it .	▁您 不必 感谢 我 。
▁I ▁wish ▁I ▁could ▁go .	▁我希望 我可以 去 。
▁She ▁is ▁going ▁to ▁M ount ▁T ate .	▁她 将 去 立 山 。
▁I ' ll ▁call ▁you ▁on ▁Monday .	▁我会 在 星期一 给你 打电话 。
▁I ▁should ▁really ▁get ▁some ▁sleep .	▁我真 该 睡 一 觉 了 。
▁R ome ▁has ▁a ▁lot ▁of ▁an ci ent ▁building s .	▁ 罗马 有很多 古 建筑 。
▁This ▁is ▁where ▁Tom ▁wants ▁to ▁live .	▁这 就是 汤姆 想 住 的地方 。
▁It ▁is ▁rude ▁to ▁st are ▁at ▁someone .	▁ 盯 著 别人 看 是不 礼貌 的 。
▁You ' re ▁imp at ient .	▁你 缺乏 耐心 。
▁Can ▁you ▁put ▁up ▁with ▁the ▁way ▁he ▁beha ves ?	▁你能 容 忍 他 做 事 的方式 么 ?
▁I ▁need ▁a ▁lot ▁of ▁books .	▁我需要 很多 书 。
▁Who ▁were ▁you ▁talking ▁with ?	▁你 和谁 说话 呢 ?
▁I ▁have ▁a ▁home .	▁我有一个 家 。
▁I ' m ▁looking ▁for ▁a ▁room ▁for ▁rent .	▁我在 找 一间 出租 的 房间 。
▁That ' s ▁a ▁good ▁question .	▁那 是一个 很好 的问题 。
▁It ▁took ▁us ▁half ▁an ▁hour ▁to ▁set ▁up ▁the ▁t ent .	▁ 搭 帐 篷 花了 我们 半 小时 。
▁I ▁didn ' t ▁go ▁to ▁school ▁yesterday .	▁昨天 你 没有 去学校 。
▁I ▁have ▁no ▁doubt ▁about ▁it .	▁我没有 疑问 。
▁This ▁is ▁the ▁best ▁restaurant ▁that ▁I ▁know .	▁这是我 所 知道的 最好的 餐厅 。
▁Tom ▁is ▁happy .	▁汤姆 高兴 。
▁Who ▁are ▁you ▁going ▁with ?	▁你 和谁 一起去 那 ?
▁How ▁about ▁din ing ▁out ▁tonight ?	▁我们 今晚 出去 吃 怎么样 ?
▁Go ▁st raight ▁on ▁down ▁this ▁street .	▁ 沿 着 这条 街 直 走 。
▁Tom ▁slept ▁with ▁his ▁shoes ▁on .	▁汤姆 穿 着 鞋 睡了 。
▁I ' m ▁going ▁to ▁change ▁my ▁shirt .	▁我要 去 换 我的 衬衫 。
▁Do ▁you ▁know ▁what ▁I ' m ▁doing ?	▁你知道 我在 做什么 吗 ?
▁I ▁don ' t ▁mind ▁hot ▁weather .	▁我不 在乎 炎 热 的天气 。
▁Maybe ▁I ' ll ▁go , ▁and ▁may be ▁I ▁won ' t .	▁也许 我会 去 , 也许 我不会 。
▁L ast ▁year , ▁he ▁spent ▁three ▁months ▁at ▁se a .	▁去年 他在 海 上 度 过了 三个月 。
▁I ▁saw ▁a ▁d irty ▁dog ▁enter ▁the ▁garden .	▁我看见 一条 脏 狗 进了 花园 。
▁When ▁he ▁ret ired , ▁his ▁son ▁took ▁over ▁the ▁business .	▁他 退休 的时候 , 他 儿子 接 手 了他的 生意 。
▁He ▁is ▁giving ▁his ▁whole ▁attention ▁to ▁that .	▁他 全 神 贯 注 。
▁How ▁can ▁Tom ▁not ▁understand ▁that ?	▁汤姆 怎么 能 不懂 ?
▁The ▁p ha r m acy ▁is ▁near ▁the ▁hospital .	▁ 药 局 在医院 附近 。
▁S uch ▁a ▁thing ▁can ' t ▁happen ▁in ▁Japan .	▁这 样 的事情 不可能 在日本 发生 。
▁We ▁live ▁in ▁a ▁three - bed room ▁house .	▁我们 住在 一 栋 有 三 间 卧室 的房子 。
▁She ▁may ▁not ▁come ▁here ▁tomorrow .	▁她 明天 可能 不会 来这里 。
▁Where ▁did ▁you ▁go ▁for ▁vacation ?	▁你 去哪里 度假 了 ?
▁There ' s ▁something ▁I ' ve ▁been ▁meaning ▁to ▁discuss ▁with ▁you .	▁有 件事 我 一直 想 跟你 商 量 。
▁The ▁dog ▁grow led ▁at ▁the ▁strange ▁man .	▁狗 对 著 这个 陌生 男 子 咆 哮 。
▁She ▁was ▁a ▁g en i us ▁in ▁mathematics .	▁她是个 数学 天 才 。
▁You ▁have ▁to ▁make ▁a ▁reservation .	▁你必须 事 先 预 约 。
▁I ▁want ▁to ▁eat ▁something ▁delicious .	▁我想 吃点 好 吃 的 。
▁We ▁are ▁all ▁looking ▁forward ▁to ▁seeing ▁you ▁and ▁your ▁family .	▁我们都 期待 看 到你 和 你的 家人 。
▁She ▁is ▁always ▁dress ed ▁in ▁black .	▁她总是 穿著 黑色的 衣服 。
▁I ▁can ' t ▁help ▁feeling ▁sorry ▁for ▁him .	▁我不 禁 为他 感到 难 过 。
▁At ▁night , ▁she ▁g az ed ▁at ▁the ▁moon .	▁她在 夜 晚 望 著 月 亮 。
▁I ' d ▁like ▁to ▁see ▁him ▁tomorrow ▁afternoon .	▁我想 明天 下午 见 他 。
▁She ▁had ▁a ▁v ag ue ▁feeling ▁of ▁gu ilt .	▁她 隐 约 地 有一 种 的 内 疚 感 。
▁He ▁wrote ▁a ▁book ▁about ▁a ▁j un g le ▁adv ent ure .	▁他 写了一 本关于 丛 林 冒 险 的书 。
▁C he ese ▁is ▁made ▁from ▁milk .	▁ 奶 酪 是用 奶 做 成的 。
▁Don ' t ▁be ▁late ▁for ▁school ▁again .	▁不要 再 上学 迟到了 。
▁I ▁can ' t ▁ad j ust ▁myself ▁to ▁the ▁clim ate ▁here .	▁我不能 让 自己 适 应 这里的 气候 。
▁Tom ▁didn ' t ▁seem ▁that ▁happy .	▁汤姆看来 不高兴 。
▁His ▁brother ▁is ▁a ▁famous ▁soccer ▁player .	▁他 弟弟 是个 有 名的 足球 选手 。
▁Tr im ▁the ▁f at ▁off ▁the ▁meat .	▁ 切 除 这 块 肉 的 脂 肪 。
▁Tom ▁needs ▁to ▁be ▁very ▁careful .	▁汤姆需要 很 小心 。
▁We ▁forg ive ▁you .	▁我们 原谅 你 。
▁It ' s ▁warm ▁for ▁this ▁time ▁of ▁year .	▁对 一年 的 这个 时候 来说 , 天气 很 温 暖 。
▁Is ▁this ▁ed ible ?	▁这个 能 吃 吗 ?
▁None ▁of ▁the ▁teacher s ▁could ▁solve ▁the ▁problem .	▁所有的 老师 都 无法 解决这个问题 。
▁A ▁book st ore ▁in ▁that ▁lo cation ▁wouldn ' t ▁make ▁enough ▁money ▁to ▁sur v ive .	▁那个 地 点 的书 店 无法 赚 足够 的钱 生 存 下去 。
▁Which ▁do ▁you ▁prefer , ▁tea ▁or ▁coffee ?	▁你 比较 喜欢 哪 一个 , 茶 还是 咖啡 ?
▁T ime ▁fl ies .	▁ 时间 匆 匆 走 过 。
▁I ' ve ▁decided ▁to ▁go ▁a ▁little ▁f ur ther .	▁我 准备 再 前 进 一点 。
▁Tom ▁would ▁accept .	▁汤姆 会 接受 。
▁They ▁were ▁only ▁interested ▁in ▁sell ing ▁books .	▁他们 只 对 卖 书 有 兴趣 。
▁Someone ▁sto le ▁my ▁wallet ▁on ▁the ▁train .	▁有人 在 火车 上 偷 了我的 钱包 。
▁Y es , ▁I ▁know ▁it .	▁是 的 , 我 知道 。
▁The ▁girl ▁re semb les ▁her ▁mother .	▁这个 女孩 酷 似 她的 母亲 。
▁Don ' t ▁let ▁this ▁information ▁le ak ▁out .	▁不要 让 这些 信息 泄 露 出去 。
▁" I s ▁she ▁coming , ▁too ?" ▁" I ▁hope ▁so ."	▁“ 她 也 会来 吗 ?” ▁“ 我 希望 是 这样 。”
▁Tom ▁has ▁come ▁up ▁with ▁a ▁good ▁plan .	▁汤姆想 到了 个 好 计划 。
▁The ▁summer ▁is ▁over .	▁ 夏天 过 去了 。
▁What ' s ▁the ▁w id th ▁of ▁this ▁road ?	▁这条 路 的 宽 度 是多少 ?
▁Tom ' s ▁house ▁has ▁three ▁bedroom s .	▁Tom 的房子 有 三个 房间 。
▁You ' ve ▁got ▁to ▁wake ▁up .	▁你必须 醒 醒 。
▁There ▁are ▁some ▁cookies ▁in ▁the ▁j ar .	▁ 罐 子里 有一些 饼 干 。
▁He ▁called ▁me ▁a ▁cab .	▁他 替 我 叫 了一 部 计程车 。
▁Tom ▁bl ushed .	▁汤姆 脸 红 了 。
▁May ▁I ▁have ▁a ▁glass ▁of ▁milk , ▁please ?	▁请问 能 给我 一杯 牛奶 吗 ?
▁She ▁made ▁tea ▁for ▁me .	▁她 给我 沏 了 茶 。
▁I ▁was ▁very ▁busy ▁last ▁week .	▁上 星期 我 非常 地 忙 。
▁He ▁climbed ▁Mt . ▁Fuji .	▁他 爬 上了 富士山 。
▁We ▁don ' t ▁have ▁any ▁other ▁choice .	▁我们 别 无 选择 。
▁His ▁mother ▁looks ▁young ▁for ▁her ▁age .	▁他 妈妈 看起来 比 实际 年龄 年轻 。
▁Has ▁Tom ▁come ▁back ▁already ?	▁汤姆 已经 回来 了吗 ?
▁Please ▁kill ▁the ▁lights .	▁请 关灯 。
▁What ▁happened ▁in ▁the ▁park ?	▁ 公园里 发生了 甚么 ?
▁I ' m ▁going ▁to ▁stay ▁here ▁for ▁a ▁couple ▁of ▁days .	▁我将 要 在这里 待 几天 。
▁Try ▁to ▁make ▁the ▁most ▁of ▁your ▁time .	▁尽 量 试着 用 好 你的 时间 。
▁He ▁drank ▁very ▁little ▁of ▁the ▁water .	▁他 喝 很少 的 水 。
▁I ▁can ▁understand ▁what ▁she ▁is ▁saying .	▁我能 了解 她在 说什么 。
▁Why ▁are ▁you ▁so ▁good ▁at ▁cooking ?	▁为什么你 做饭 那么 拿 手 呢 ?
▁E le ct ric ity ▁is ▁very ▁useful .	▁ 电 很有 用 。
▁What ' re ▁you ▁after ?	▁你想要什么 ?
▁Can ▁you ▁tell ▁me ▁where ▁the ▁f le a ▁market ▁is ?	▁你能 告诉我 跳 蚤 市场 在哪里 吗 ?
▁Tom ▁doesn ' t ▁have ▁a ▁m ic row ave ▁o ven .	▁汤姆没有 微 波 炉 。
▁My ▁whole ▁bo dy ▁hurts .	▁我全 身 酸 痛 。
▁Would ▁you ▁care ▁for ▁another ▁glass ▁of ▁beer ?	▁再 来 一杯 啤酒 怎么样 ?
▁If ▁not ▁now , ▁when ?	▁如果 不是 现在 , 那是 什么时候 ?
▁Wait ▁and ▁see .	▁走 著 瞧
▁Tom ▁is ▁in ▁the ▁hospital .	▁Tom 在医院 。
▁He ▁is ▁on ▁good s ▁t erm s ▁with ▁all ▁of ▁his ▁classm ates .	▁他 和他 所有的 同学 相处 融 洽 。
▁In ▁the ▁light ▁of ▁what ▁you ▁told ▁us , ▁I ▁think ▁we ▁should ▁re v ise ▁our ▁plan .	▁ 根据 你 所 说的话 , 我 认为 我们 应该 重 新 审 视 我们的 计划 。
▁It ' s ▁very ▁difficult .	▁这 很难 。
▁I ▁was ▁going ▁to ▁work ▁here ▁all ▁day .	▁我要 在这里 工作 一整天 。
▁She ▁h ugg ed ▁him .	▁她 抱 了他 。
▁Somebody ▁caught ▁me ▁by ▁the ▁arm .	▁有人 抓住 了我的 手臂 。
▁Have ▁you ▁finished ▁reading ▁that ▁novel ?	▁你 读完 那 本 小说 了吗 ?
▁I ▁am ▁glad ▁that ▁you ▁have ▁succeed ed .	▁我很高兴 你们 成功 了 。
▁Be ▁sure ▁to ▁pick ▁up ▁some ▁milk .	▁ 务 必要 买 一些 牛奶 。
▁I ' ve ▁finished ▁water ing ▁the ▁flowers .	▁我已经 浇 完 花了 。
▁I ▁owe ▁everything ▁to ▁Tom .	▁我 什么都 欠 汤姆的 。
▁A p art ▁from ▁some ▁fruit , ▁he ▁hasn ' t ▁eaten ▁anything .	▁除了 水果 , 他 什么都 没 吃 。
▁I ' m ▁taking ▁care ▁of ▁my ▁grandfather .	▁我 照顾 我的 爷爷 。
▁L angu age ▁is ▁the ▁means ▁by ▁which ▁people ▁comm un ic ate ▁with ▁others .	▁ 语言 是 人们 与 他 人 交 流 的 手 段 。
▁Does ▁anyone ▁want ▁some ▁more ▁pie ?	▁有人 想要 更多 的 馅 饼 吗 ?
▁Do ▁you ▁know ▁how ▁to ▁use ▁a ▁computer ?	▁您 会 使用 计 算 机 吗 ?
▁O f ▁course !	▁当 然 !
▁How ▁are ▁your ▁parents ▁getting ▁along ?	▁你的 父母 是 如何 相处 的 ?
▁Her ▁look ▁says ▁that ▁she ▁loves ▁you .	▁她的 样子 在 说她 爱你 。
▁Are ▁you ▁Tom ?	▁你是 汤姆吗 ?
▁I ▁hope ▁I ▁can ▁see ▁you ▁soon .	▁我希望 很快就 能 见到你 。
▁I ▁run ▁every ▁day .	▁我每天 跑步 。
▁When ▁will ▁you ▁leave ?	▁你什么时候 离开 ?
▁Tom ▁is ▁in ▁the ▁other ▁room ▁drinking ▁v od k a .	▁Tom 在 别 的 房间 喝 伏 特 加 。
▁I ' ll ▁clean ▁up ▁the ▁kitchen ▁later .	▁我 等 一下 将 清 理 厨房 。
▁He ▁and ▁I ▁were ▁in se p ar able ▁friends ▁during ▁our ▁time ▁together ▁in ▁school .	▁我和 他在 学生 时 代 是 分 不 开 的朋友 。
▁We ▁go ▁to ▁the ▁same ▁school .	▁我们 上 同 一 所 学校 。
▁You ▁are ▁as ▁tall ▁as ▁I ▁am .	▁你 和我 一样高 。
▁She ▁bought ▁two ▁p ound s ▁of ▁butter .	▁她 买了 两 磅 的 奶油 。
▁He ' s ▁a ▁good ▁person .	▁他 是个好 人 。
▁That ▁to y ▁is ▁made ▁of ▁wood .	▁这个 玩具 是用 木 头 做的 。
▁We ▁can ' t ▁see ▁the ▁other ▁side ▁of ▁the ▁moon .	▁我们 看 不到 月 亮 的 另 一边 。
▁Tom ▁fell ▁asleep .	▁汤姆 睡着了 。
▁I ▁think ▁this ▁book ▁is ▁easy .	▁我觉得 这本书 很 简单 。
▁Our ▁friends hip ▁will ▁last ▁a ▁long ▁time .	▁我们的 友 情 会 长 久 留 存 。
▁Were ▁you ▁able ▁to ▁do ▁it ?	▁你有 能力 去做 这个吗 ?
▁Yesterday ▁I ▁met ▁Mary ▁on ▁the ▁street .	▁昨天 我在 街 上 遇见 了玛丽 。
▁My ▁house ▁is ▁near ▁the ▁station .	▁我家 离 火车站 很 近 。
▁Why ▁don ' t ▁you ▁grow ▁up ?	▁你为什么 长 不 大 呢 ?
▁Who ' ll ▁be ▁elected ▁chair man ?	▁谁 将 当 选 主 席 呢 ?
▁It ▁is ▁getting ▁li gh ter ▁outside .	▁ 外面 天 色 越来越 亮 了 。
▁So ▁you ▁give ▁up , ▁right ?	▁ 所以 你 放弃 了 , 是吗 ?
▁Nobody ▁tried ▁to ▁help ▁Tom .	▁没人 试图 帮 汤姆 。
▁We ▁made ▁p anc akes ▁for ▁breakfast .	▁我们 早餐 做了 煎 饼 。
▁Which ▁club ▁do ▁you ▁belong ▁to ?	▁你 属于 哪个 社 团 ?
▁I ▁didn ' t ▁understand ▁a ▁single ▁word ▁Tom ▁said .	▁我不 明白 汤姆 说了什么 。
▁I ▁need ▁to ▁know ▁tomorrow .	▁我明天 需要 知道 。
▁I ▁really ▁look ▁forward ▁to ▁your ▁visit ▁in ▁the ▁near ▁future .	▁我很 期待 在 不 久 的 将 来 您的 光 临 。
▁You ' ll ▁be ▁able ▁to ▁see ▁the ▁difference ▁very ▁easily .	▁你们 很容易 就能 看 出 区 别 。
▁I ▁like ▁j o gg ing .	▁我喜欢 跑步 。
▁I ▁think ▁I ' ll ▁stay .	▁我 认 我会 留 下 。
▁I ▁think ▁we ' re ▁in ▁trouble .	▁我认为我们 有 麻烦 。
▁I ▁feel ▁like ▁crying .	▁我想 哭 。
▁He ' s ▁just ▁gone ▁on ▁leave .	▁他刚 请 假 走了 。
▁Nothing ▁happened .	▁ 什么事 都没有 发生 。
▁I ▁haven ' t ▁seen ▁him ▁for ▁years .	▁我有 些 年 没见过 他了 。
▁My ▁brother ▁is ▁a ▁first - y ear ▁student .	▁我 弟弟 是个 一年 级 的学生 。
▁My ▁phone ▁was ▁out ▁of ▁order .	▁我的 电话 坏了 。
▁My ▁father ▁works ▁at ▁the ▁factory .	▁我父亲 在 工厂 工作 。
▁Tom ▁fell ▁off ▁his ▁bicycle .	▁汤姆从 他的 自行车 上 掉了 下来 。
▁If ▁I ▁were ▁you , ▁I ' d ▁want ▁to ▁know ▁what ▁Tom ▁is ▁doing ▁right ▁now .	▁如果我 是你 , 我不会 想去 知道 Tom 现在 正在 做什么 。
▁Tom ' s ▁Japanese ▁is ▁impro ving ▁little ▁by ▁little .	▁汤姆的 日语 一点 一点 地 渐 渐 进步 中 。
▁He ▁caught ▁her ▁by ▁the ▁arm .	▁他 抓 住了 她的 胳 膊 。
▁Now ▁tell ▁us ▁what ▁we ▁want ▁to ▁know .	▁现在 告诉我们 我们 想知道 的 。
▁Do ▁you ▁need ▁to ▁wash ▁fresh ▁vegetables ?	▁ 生 菜 要 洗 吗 ?
▁There ' s ▁something ▁I ▁have ▁to ▁say .	▁有些 事 我 必须 说 。
▁Tom ▁changed ▁into ▁his ▁un if orm .	▁汤姆 换 上 制 服 。
▁Can ▁you ▁pass ▁me ▁the ▁salt , ▁please ?	▁请你把 盐递给我 好吗 ?
▁She ▁was ▁sus cept ible ▁to ▁cold s .	▁她 易 患 感冒 。
▁He ▁has ▁a ▁strong ▁sense ▁of ▁respons ib ility .	▁他有 强 烈 的 责任 感 。
▁Is l am ▁first ▁reached ▁China ▁about ▁the ▁mid d le ▁of ▁the ▁7 th ▁cent ury .	▁ 伊 斯 兰 教 大约 在 七 世纪 中 传 到 中国 。
▁How ▁do ▁you ▁feel ▁about ▁the ▁is s ue ?	▁你对 这个问题 有 甚么 感 受 ?
▁Please ▁show ▁me ▁the ▁green ▁shirt .	▁请给我 看看 这件 绿 色的 衬衫 。
▁Don ' t ▁throw ▁out ▁this ▁magazine . ▁I ▁haven ' t ▁read ▁it ▁yet .	▁这本 杂志 不要 扔 。 我 还没 看 呢 。
▁You ▁are ▁lying .	▁你在 撒谎 。
▁I ▁made ▁eff orts ▁to ▁impro ve ▁my ▁grad es .	▁我 努力 的 改 善 我的 成绩 。
▁You ▁ought ▁not ▁to ▁go ▁out .	▁你不应该 出门 。
▁You ▁are ▁responsible ▁for ▁the ▁result .	▁你要 对 结果 负责 。
▁I ▁must ▁have ▁caught ▁a ▁cold .	▁我 肯定 着 凉 了 。
▁Something ▁is ▁wrong ▁with ▁my ▁watch .	▁我的 手表 坏了 。
▁She ▁gave ▁him ▁a ▁watch .	▁她给 了他 一 块 表 。
▁Please ▁turn ▁up ▁the ▁A C ▁a ▁little ▁bit .	▁请你把 冷 气 调 高 点 。
▁Can ▁I ▁borrow ▁your ▁pencil ▁for ▁a ▁bit ?	▁我能 用 一下 你的 铅笔吗 ?
▁I ▁don ' t ▁like ▁movies .	▁我不喜欢 电影 。
▁I ▁didn ' t ▁tell ▁the ▁whole ▁truth .	▁我没 把 真相 全 告诉你 。
▁Tom ▁didn ' t ▁think ▁that ▁anybody ▁would ▁recogn ize ▁Mary .	▁汤姆不 认为 有人 会 认 出 玛丽 。
▁I ▁int end ▁to ▁go ▁there .	▁我打算 去那里 。
▁How ▁is ▁your ▁business ▁going ?	▁你的 生意 进 展 如何 ?
▁He ▁took ▁out ▁his ▁passport .	▁他 拿 出 了他的 护照 。
▁Go ▁back ▁to ▁your ▁seat .	▁ 回 到 你的 座位 。
▁They ▁h ugg ed .	▁他们 拥 抱 。
▁Those ▁two ▁children ▁were ▁the ▁same ▁age .	▁那 两个 小孩 同 岁 。
▁We ' ll ▁be ▁here ▁for ▁three ▁more ▁days .	▁我们 还 要 在这里 待 三天 。
▁I ' d ▁like ▁to ▁order ▁drinks ▁now .	▁我现在 想 点 饮料 。
▁The ▁world ▁doesn ' t ▁re v ol ve ▁around ▁you .	▁世界 不是 围 着 你 转 的 。
▁He ▁was ▁afraid ▁of ▁being ▁laughed ▁at .	▁他怕 被 嘲笑 。
▁Will ▁it ▁rain ▁tomorrow ?	▁明天 会 下雨 吗 ?
▁We ' ve ▁got ▁what ▁we ▁need .	▁我们 得到了 我们 想要的 。
▁I ▁know ▁her ▁address .	▁我知道 她的 地址 。
▁Are ▁you ▁free ▁right ▁now ?	▁你现在 有空 吗 ?
▁R ab bit s ▁have ▁long ▁ear s ▁and ▁short ▁t ail s .	▁ 兔 子 长 着 长 长 的 耳朵 和 短 短 的 尾 巴 。
▁Why ▁don ' t ▁we ▁stop ▁arg u ing ▁over ▁these ▁p id d ling ▁matter s ▁and ▁get ▁to ▁the ▁is s u es ▁at ▁hand ?	▁为什么 我们 不 停止 为 细 枝 末 节 的 争 吵 而 进入 正 题 呢 ?
▁Don ' t ▁you ▁want ▁to ▁know ▁why ?	▁你不 想知道 为什么 吗 ?
▁How ▁do ▁you ▁pr on oun ce ▁your ▁name ?	▁你怎么 念 你的 名字 ?
▁Is ▁this ▁the ▁train ▁for ▁New ▁York ?	▁这 班 是 去 纽约 的火车 吗 ?
▁Please ▁remember ▁what ▁he ▁said .	▁请 记 住 他说的话 。
▁Tom ▁doesn ' t ▁have ▁to ▁thank ▁me .	▁汤姆不 需要 谢 我 。
▁I ▁want ▁to ▁talk ▁to ▁him .	▁我想 跟他 说话 。
▁I ' d ▁like ▁to ▁change ▁my ▁reservation .	▁我想 更 改 我的 预订 。
▁I ▁will ▁ask ▁him ▁tomorrow .	▁我明天 会 问他 。
▁I ▁was ▁terri b ly ▁confused ▁by ▁his ▁question .	▁我对 他的 问题 感到 非常 迷 惑 。
▁You ▁need ▁a ▁large ▁v oc ab ul ary ▁to ▁read ▁that ▁book .	▁你 读 那 本书 需要 大量 词 汇 。
▁Could ▁you ▁lend ▁me ▁your ▁bicycle ▁for ▁a ▁couple ▁of ▁days ?	▁你能 把你的 自行车 借我 两天 吗 ?
▁I ' ll ▁ar r ange ▁for ▁someone ▁to ▁pick ▁you ▁up ▁at ▁your ▁home .	▁我会 安 排 一下 , 叫 个人 去 你 家 接 你 。
▁Does ▁she ▁know ▁your ▁phone ▁number ?	▁她 知道 你的 电话号码 ?
▁They ▁always ▁wake ▁up ▁early , ▁even ▁on ▁Sundays .	▁他们 总是 早起 , 即 使 是在 周日 。
▁Tom ▁will ▁go ▁there ▁tomorrow .	▁汤姆 明天 会 去那里 。
▁He ▁is ▁very ▁busy ▁writing ▁st ories .	▁他 忙 于 写 故事 。
▁I ▁don ' t ▁have ▁anyone ▁who ' d ▁travel ▁with ▁me .	▁我没有 一个 愿意 跟我 一起 旅行 的人 。
▁The ▁moon ▁is ▁sh in ing .	▁ 月 光 在 照 耀 著 。
▁You ▁can ▁come ▁in .	▁你可以 进来 。
▁I ▁filled ▁up ▁the ▁v ase ▁with ▁water .	▁我 倒 水 进 去 花 瓶 里 。
▁I ▁don ' t ▁like ▁children .	▁我不喜欢 小孩 。
▁I ▁don ' t ▁want ▁to ▁lose ▁you .	▁我不想 失去 你 。
▁She ▁ins ist ed ▁that ▁I ▁should ▁see ▁the ▁doctor .	▁她 坚持 让我 去看 医生 。
▁I ▁ad ver t ised ▁my ▁car ▁for ▁sa le .	▁我 登 广告 卖 我的 车 。
▁Tom ▁taught ▁me ▁French .	▁汤姆 教 了我 法语 。
▁Go ▁up ▁the ▁st airs .	▁上 楼 。
▁You ▁have ▁a ▁point ▁there .	▁ 喔 ! 你 提 到 一个 重 点了 。
▁We ' re ▁going ▁to ▁set ▁up ▁she l ter s .	▁我们要 建 立 避 难 所 。
▁She ▁married ▁him ▁for ▁his ▁money .	▁她为 了他的 钱 嫁 给 了他 。
▁There ▁is ▁a ▁bus ▁every ▁20 ▁minutes .	▁每 20 分钟 有一 班 车 。
▁If ▁it ▁is ▁fine ▁tomorrow , ▁we ' ll ▁go ▁on ▁a ▁picnic .	▁如果 明天 天气 好 , 我们就 去 野餐 。
▁I ▁want ▁to ▁lose ▁weight .	▁我想 减 肥 。
▁Are ▁you ▁going ▁to ▁sing ?	▁你要 唱歌 吗 ?
▁We ▁have ▁a ▁little ▁time ▁left .	▁我们 还有 一点 时间 。
▁I ▁am ▁glad ▁to ▁have ▁her ▁company .	▁我很高兴 有 她的 陪 伴 。
▁St uff ▁happens .	▁ 事情 难 免 会发生 。
▁He ▁is ▁very ▁kind .	▁他非常 亲 切 。
▁Thank ▁you ▁just ▁the ▁same .	▁ 还是 要 说 谢谢 的 。
▁Tom ▁didn ' t ▁write ▁back ▁to ▁Mary .	▁汤姆没 给玛丽 写 回 复 。
▁Go ▁to ▁the ▁pat io .	▁去 露 台 。
▁Do ▁you ▁want ▁to ▁hear ▁it ?	▁您想 听 它 吗 ?
▁They ▁ad op ted ▁the ▁little ▁girl .	▁他们 收 养 了 那个 小 女孩 。
▁We ▁were ▁on ▁the ▁train ▁for ▁ten ▁hours .	▁我们在 火车 上 十 个 小时 。
▁Do ▁they ▁speak ▁French ▁in ▁Canada ?	▁他们在 加拿大 说法语 吗 ?
▁It ▁cost ▁me ▁ten ▁thousand ▁yen ▁to ▁have ▁my ▁television ▁set ▁repaired .	▁把 我的 电视机 修 好 花 了我 一 万日元 。
▁Tom ▁just ▁doesn ' t ▁understand .	▁汤姆 就是 不懂 。
▁There ▁was ▁no ▁water ▁in ▁the ▁river .	▁ 河 里 没有 水 了 。
▁I ' m ▁not ▁as ▁strong ▁as ▁I ▁used ▁to ▁be .	▁我不 跟 以前 一样 强 壮 了 。
▁She ▁killed ▁herself ▁yesterday .	▁她昨天 自 杀了 。
▁My ▁mother ▁has ▁good ▁hand w rit ing .	▁我母亲 的 笔 迹 很好 看 。
▁These ▁box es ▁are ▁made ▁of ▁pl ast ic .	▁这些 箱子 是由 塑 料 制 成的 。
▁This ▁is ▁my ▁mother .	▁这是我 母亲 。
▁Why ▁do ▁you ▁think ▁that ▁I ' m ▁thinking ▁about ▁you ?	▁你为什么 会 认为 我在 想你 ?
▁A ▁c aged ▁cr icket ▁eats ▁just ▁as ▁much ▁as ▁a ▁free ▁cr icket .	▁ 笼 子 里的 蟋 蟀 吃 得 跟 野 生 的 蟋 蟀 一样 多 。
▁People ▁show ▁up ▁b right ▁on ▁an ▁inf ra red ▁camera ▁because ▁of ▁their ▁bo dy ▁he at .	▁人 会 因为 体 温 而 在 红 外 线 摄 影 机 上 显 现 。
▁A ▁drunk ▁driver ▁was ▁responsible ▁for ▁the ▁car ▁accident .	▁ 喝 醉 的 驾驶 员 对 车 祸 有 责任 。
▁Japanese ▁history ▁is ▁my ▁favorite ▁subject .	▁日本 历史 是我最喜欢的 科目 。
▁She ▁does ▁not ▁like ▁sushi .	▁她不喜欢 寿司 。
▁I ▁agree ▁with ▁him .	▁我同意 他 。
▁I ▁have ▁no ▁friends ▁to ▁help ▁me .	▁我没 朋友 帮我 。
▁Good ▁job !	▁ 干 的好 !
▁When ▁will ▁it ▁start ?	▁什么时候开始 ?
▁Tom ▁has ▁been ▁gone ▁for ▁ag es .	▁汤姆 年纪 大 去世了 。
▁I ▁wish ▁you ' d ▁go .	▁我希望你 去 。
▁Did ▁she ▁show ▁you ▁the ▁picture ?	▁她 给你 看过 照片 了吗 ?
▁He ▁wrote ▁to ▁me ▁yesterday .	▁昨天 他 写信 给我 。
▁We ▁should ▁can ce l ▁the ▁h ike .	▁我们应该 取消 这次 远 足 。
▁The ▁train ▁is ▁d ue ▁to ▁arrive ▁at ▁noon .	▁火车 该 在 中午 到 。
▁This ▁makes ▁me ▁happy .	▁这 让我 开心 。
▁This ▁old ▁house ▁is ▁ha un ted .	▁这个 老 房子 闹 鬼 。
▁The ▁third ▁qu ar ter ▁G N P ▁grow th ▁was ▁1 % ▁over ▁the ▁pre ced ing ▁qu ar ter .	▁ 第 三 季 国 民 生 产 总 值 较 上 一 季 成 长 了 1 % 。
▁Tom ▁rob bed ▁a ▁bank .	▁汤姆 抢 了 家 银行 。
▁I ' m ▁just ▁playing ▁the ▁de v il ' s ▁adv oc ate .	▁我在 给 魔 鬼 当 辩 护士 。
▁It ▁is ▁hard ▁for ▁me ▁to ▁believe ▁this .	▁我觉得 这 难以 置 信 。
▁Some ▁dis e as es ▁are ▁ca used ▁by ▁a ▁de fect ive ▁g en e .	▁一些 疾 病 的 产 生 原因 是 基 因 缺 陷 。
▁He ▁tried ▁to ▁conc ent r ate ▁on ▁the ▁letter .	▁他 试图 把 注意 力 集 中 在 信 上 。
▁He ▁took ▁a ▁week ▁off .	▁他 休 了一 周 的 假 。
▁Tom ▁doesn ' t ▁have ▁a ▁good ▁French - E ngl ish ▁dictionary .	▁Tom 没有 一本 好的 法 英 字典 。
▁As ▁far ▁as ▁I ▁know , ▁there ▁is ▁nothing ▁wrong ▁with ▁his ▁plan .	▁据 我 所知 , 他的 计划 没有 出 差 错 。
▁Tom ▁came ▁a ▁little ▁earlier ▁today ▁than ▁he ▁usually ▁does .	▁汤姆 今天 来 得 比 往 常 要 早 一些 。
▁He ▁took ▁us ▁back ▁in ▁his ▁car .	▁他 开车 送 我们 回来的 。
▁Some ▁of ▁the ▁ ess ays ▁are ▁very ▁interesting .	▁这些 文章 中 有一些 非常有趣 。
▁She ▁had ▁died ▁before ▁I ▁arrived .	▁她在 我 到达 之前 去世了 。
▁I ' m ▁getting ▁more ▁and ▁more ▁gr ay ▁hair .	▁我的 白 发 越来越 多 。
▁Would ▁you ▁please ▁look ▁after ▁my ▁dog ▁tomorrow ?	▁你明天 可以 帮我 照顾 一下 我的 狗 吗 ?
▁I ▁hope ▁I ' m ▁not ▁dist ur b ing ▁you .	▁我希望 没 打扰 到你 吧 ?
▁This ▁question ▁is ▁very ▁simple .	▁这个 问题 很 简单 。
▁A ▁lot ▁of ▁students ▁around ▁the ▁world ▁are ▁studying ▁English .	▁ 世界上 许多 学生 正在 学习英语 。
▁Water ▁bo il s ▁at ▁100 ▁deg rees .	▁水 在 摄 氏 100 度 沸 腾 。
▁You ▁should ▁have ▁known ▁better ▁than ▁to ▁take ▁an ▁exam ination ▁without ▁prep ar ing ▁for ▁it .	▁你应该 知道 要 为 考试 作 准备 。
▁I ▁feel ▁like ▁I ' m ▁going ▁to ▁f ain t .	▁我觉得 我 快 昏 倒了 。
▁John ▁is ▁two ▁years ▁older ▁than ▁I ▁am .	▁John 比我 大 两 岁 。
▁The ▁things ▁he ▁says ▁are ▁not ▁the ▁least ▁bit ▁important .	▁他 说的话 根本 毫无 意义 。
▁Do ▁you ▁have ▁a ▁po in ts ▁card ?	▁您 有 会员 卡 吗 ?
▁You ▁can ▁eat ▁whatever ▁you ▁like .	▁你可以 吃 你喜欢 的东西 。
▁I ▁got ▁lost ▁in ▁the ▁forest .	▁我在 树 林里 迷路 了 。
▁There ▁goes ▁our ▁bus .	▁我们的 车 走了 。
▁Can ▁I ▁drive ▁the ▁tr act or ?	▁我能 开 拖 拉 机 吗 ?
▁He ▁died ▁of ▁lun g ▁cancer .	▁他 死于 肺 癌 。
▁He ▁broke ▁up ▁the ▁chair ▁for ▁fire w ood .	▁他 摔 断了 椅子 当 柴 火 。
▁I ▁got ▁her ▁to ▁clean ▁my ▁room .	▁我 让她 把我的 房间 弄 干净 。
▁Would ▁you ▁mind ▁lend ing ▁me ▁your ▁pen ?	▁你介意 借我 你的 笔 吗 ?
▁He ▁would ▁often ▁come ▁to ▁see ▁us ▁when ▁I ▁was ▁a ▁child .	▁当我 还 是个孩子 时 , 他 经常 来看 望 我们 。
▁I ▁thank ▁you ▁very ▁much ▁for ▁your ▁kind ness .	▁我 十分 感谢 你的 好 意 。
▁She ▁gave ▁birth ▁to ▁a ▁daughter ▁yesterday .	▁她昨天 生 了一个 女儿 。
▁It ▁cost ▁me ▁a ▁thousand ▁yen ▁to ▁get ▁my ▁bicycle ▁fix ed .	▁ 修理 我的 脚踏车 花 了我 一 千 日 圆 。
▁The ▁family ▁is ▁watching ▁a ▁movie ▁together .	▁这 一 家人 一起 看 电影 。
▁He ▁married ▁a ▁pretty ▁girl .	▁他 娶 了一个 漂亮的 女孩 。
▁E ver ▁since ▁she ▁fell ▁in ▁the ▁kitchen , ▁she ▁hasn ' t ▁been ▁all ▁there .	▁自 从 她在 厨房 里 摔 倒 后 , 她 不 曾 再 到那里 。
▁Tom ▁was ▁the ▁first ▁to ▁re act .	▁汤姆是 最 先 作 出 反 应 的 。
▁Please ▁add ▁up ▁the ▁bill .	▁请 确 认 帐 单 。
▁I ▁r i pped ▁my ▁p ants .	▁我 扯 掉了 自己的 裤子 。
▁Let ' s ▁go ▁to ▁a ▁movie .	▁让我们 去看电影 。
▁I ' ve ▁got ▁a ▁lot ▁more ▁to ▁learn .	▁我要 学 很多 。
▁They ▁st e pped ▁a ▁few ▁p aces ▁forward .	▁他们 前 进了 几 步 。
▁I ▁should ▁clean ▁my ▁room .	▁我应该 打扫 我的 房间 。
▁That ' s ▁a ▁nice ▁coat .	▁那 是一 件 不错 的 大衣 。
▁I ▁don ' t ▁know ▁if ▁today ▁is ▁T u es day ▁or ▁W ed n es day .	▁我不知道 今天 是 星期 二 还是 星期 三 。
▁What ' s ▁your ▁home ▁phone ▁number ?	▁你 家 的 电话号码 几 号 ?
▁I ▁met ▁him ▁on ▁his ▁way ▁home .	▁在 他 回家 的路上 我 遇见 了他 。
▁I ▁have ▁an ▁ urg ent ▁mess age ▁from ▁Tom .	▁我 收到 汤姆的 一条 紧急 消息 。
▁F ill ▁in ▁your ▁name ▁and ▁address .	▁ 填 上你的 姓 名 和 地址 。
▁Tom ▁isn ' t ▁unhappy .	▁汤姆不是 不高兴 。
▁Are ▁you ▁going ▁to ▁attend ▁the ▁meeting ?	▁你要 参加会议 吗 ?
▁His ▁sudden ▁appe ar ance ▁surprised ▁us ▁all .	▁他的 突然 出现 , 让我们 都 感到 惊讶 。
▁Any ▁em ot ion , ▁if ▁it ▁is ▁since re , ▁is ▁invol unt ary .	▁ 任何 情 绪 , 只 要 它是 真 诚 的 , 就 说明 它是 发 自 内 心 的 自然 流 露 。
▁Give ▁me ▁something ▁to ▁eat .	▁给我 点东西 吃 。
▁He ▁divorced ▁his ▁wife ▁last ▁month .	▁上 个月 他 和 妻子 离婚 了 。
▁Life ▁would ▁be ▁impossible ▁without ▁the ▁sun .	▁没有 太阳 就 没有 生命 。
▁He ▁never ▁said ▁that .	▁他从 来 没 说过 那个 。
▁The ▁dog ▁is ▁blind ▁in ▁one ▁eye .	▁这只狗 的 一只 眼睛 瞎 了 。
▁You ' re ▁not ▁satisfied , ▁are ▁you ?	▁你 并不 满意 , 对 吧 ?
▁He ▁gave ▁correct ▁answ ers ▁to ▁the ▁questions .	▁他对 这个问题 给了 正确的 答案 。
▁Do ▁you ▁know ▁how ▁to ▁drive ▁this ▁thing ?	▁你知道 怎么 驾驶 这 玩 意 儿 吗 ?
▁I ▁love ▁you .	▁我爱 您 。
▁We ▁need ▁to ▁buy ▁a ▁new ▁TV .	▁我们需要 买 新 电视机 。
▁I ▁like ▁short ▁hair .	▁我喜欢 短 发 。
▁My ▁mother ▁made ▁me ▁take ▁some ▁medicine .	▁我妈妈 让我 吃点 药 。
▁There ▁is ▁an ▁orange ▁on ▁the ▁table .	▁ 桌上 有一 只 橙子 。
▁Tom ▁lived ▁there .	▁汤姆 住在这里 。
▁She ▁doesn ' t ▁like ▁people ▁who ▁aren ' t ▁pun ct ual .	▁她不喜欢 不 守 时 的人 。
▁This ▁is ▁a ▁small ▁town .	▁这是个 小 镇 。
▁They ' re ▁afraid ▁of ▁us .	▁他们 害怕 我们 。
▁I ▁arrived ▁at ▁the ▁village ▁before ▁dark .	▁我 天 黑 之前 到达 了 村 庄 。
▁I ▁studied ▁for ▁one ▁hour .	▁我 读 了一个 小时 的书 。
▁Tom ▁fell ▁asleep ▁sitting ▁up ▁in ▁the ▁chair .	▁汤姆 坐在 椅子 上 睡着了 。
▁Tom ▁will ▁be ▁there , ▁won ' t ▁he ?	▁汤姆 会 去那里 , 不是么 ?
▁Did ▁you ▁watch ▁the ▁soccer ▁game ▁on ▁television ?	▁你在 电视 上 看 足球 赛 了吗 ?
▁Tom ▁kept ▁talking ▁all ▁night .	▁汤姆 整夜 一直 在 说话 。
▁We ▁managed ▁to ▁swim ▁across ▁the ▁river .	▁我们 成功 地 游 过了 河 。
▁He ▁is ▁a ▁famous ▁comp os er .	▁他 是一位 著 名的 作 曲 家 。
▁No ▁one ▁was ▁late .	▁没有人 迟到 。
▁Do ▁you ▁want ▁to ▁get ▁married ▁first ▁or ▁have ▁a ▁child ▁first ?	▁你想 我们 先 结婚 还是 先 生 孩子 ?
▁Please ▁come ▁again ▁in ▁three ▁days ▁time .	▁请在 三天 内 回来 。
▁He ▁visited ▁his ▁h omet own ▁for ▁the ▁first ▁time ▁in ▁ten ▁years .	▁他 10 年 中 第一次 访问 他的 故 乡 。
▁Did ▁you ▁lock ▁the ▁door ?	▁你有 关门 吗 ?
▁S it ▁b es ide ▁me .	▁ 坐 我 旁边 。
▁I ▁didn ' t ▁tell ▁Tom ▁what ▁needed ▁to ▁be ▁done .	▁我没 告诉汤姆 要 做甚么 。
▁May ▁I ▁see ▁your ▁bo ard ing ▁pass , ▁please ?	▁请让我 看看 您的 登 机 证 好吗 ?
▁I ' d ▁like ▁you ▁to ▁have ▁an ▁ ult r as ound .	▁我想让你 接受 超 声 检查 。
▁Go ▁home ▁quickly .	▁ 赶 快 回家 。
▁I ▁study ▁K ore an .	▁我 学 韩 语 。
▁I ▁talked ▁with ▁her ▁for ▁an ▁hour .	▁我 跟她 谈 了一个 小时 。
▁He ▁hur ried ▁so ▁he ▁wouldn ' t ▁miss ▁the ▁train .	▁汤姆 加 紧 步 伐 以 不错 过 火车 。
▁He ▁is ▁a ▁sc rew ball .	▁他 是一个 怪 人 。
▁What ▁do ▁you ▁do ▁after ▁school ?	▁你 放学 以后 干什么 ?
▁Your ▁opinion ▁matter s .	▁你的 观 点 是 重要 的 。
▁A ▁fire ▁broke ▁out ▁during ▁the ▁night .	▁在 夜 间 发生了 火灾 。
▁She ▁answered ▁in ▁tears .	▁她很 伤 心 地 回答 。
▁Japan ▁is ▁lo c ated ▁in ▁the ▁N ort her n ▁He m is p here .	▁日本 位 于 北 半 球 。
▁His ▁memory ▁amaz es ▁me .	▁他的 记忆 力 使我 惊讶 。
▁He ▁was ▁standing ▁at ▁the ▁street ▁corner .	▁他 站在 街 角 。
▁I ▁don ' t ▁want ▁any ▁more .	▁我不 想要 了 。
▁I ▁can ' t ▁make ▁an ▁except ion .	▁我不能 破 例 。
▁If ▁you ▁stay ▁at ▁a ▁big ▁hotel , ▁you ▁can ▁use ▁their ▁swimming ▁p ool .	▁ 若 你 住 到 的是 大的 旅馆 , 就能 使用 他们的 游泳 池 。
▁The ▁movie ▁the ater ▁was ▁filled ▁with ▁people .	▁这家 电影 院 挤 满了 人 。
▁Tom ▁speaks ▁French ▁a ▁little .	▁汤姆 会 说 一点 法语 。
▁Tom ▁is ▁clean .	▁汤姆是 干净 的 。
▁Tom ▁ab st ained ▁from ▁v ot ing .	▁汤姆 投 票 弃 权 。
▁You ▁should ▁apologize ▁for ▁your ▁r ud en ess .	▁您 该 为 您的 粗 鲁 道歉 。
▁P ass ▁me ▁the ▁salt , ▁would ▁you ?	▁把 盐递给我 好吗 ?
▁I ▁cannot ▁agree ▁with ▁you ▁on ▁the ▁matter .	▁在这 件事 上 , 我 无法 赞 同 你 。
▁Our ▁supp l ies ▁are ▁running ▁out .	▁我们的 供 给 要 用 完了 。
▁The ▁teacher ▁made ▁him ▁stay ▁after ▁school .	▁老师 要 他 放学后 留在 学校 。
▁Your ▁hair ▁is ▁pretty .	▁你的 头发 很 漂亮 。
▁I ▁can ' t ▁live ▁without ▁you .	▁没有 你 我 活 不 下去 。
▁I ▁was ▁in ▁Tokyo ▁yesterday .	▁我昨天 在 东京 。
▁When ▁we ▁started ▁out , ▁our ▁b and ▁could ▁only ▁find ▁small ▁club s ▁in ▁small ▁c ities ▁that ▁would ▁h ire ▁us .	▁当 我们 起 步 时 , 我们的 乐 队 只 能 找 小 城市 里的 小 俱乐部 雇 我们 。
▁My ▁camera ▁is ▁different ▁from ▁yours .	▁我的 相机 跟 你的 不同 。
▁Just ▁say ▁no .	▁只要 说不 。
▁I ▁will ▁teach ▁you ▁to ▁play ▁che ss .	▁我会 教 你 下 棋 。
▁It ▁looks ▁like ▁it ' s ▁going ▁to ▁snow .	▁ 看起来 快 下雪了 。
▁The ▁le ct ure ▁last ed ▁for ▁two ▁hours .	▁这场 演讲 持续 了 两个 小时 。
▁The ▁weather ▁report ▁says ▁we ' ll ▁get ▁three ▁inc hes ▁of ▁snow .	▁天气 预 报 说 会 下 三 英 寸 雪 。
▁We ▁watch ▁TV ▁every ▁day .	▁我们 每天 看电视 。
▁I ▁have ▁to ▁stay ▁in ▁bed ▁all ▁day .	▁我不 得不 一整天 都 待 在床上 。
▁That ' s ▁a ▁hard ▁question ▁to ▁answer .	▁那 是一个 很难 回答 的问题 。
▁This ▁house ▁belong s ▁to ▁my ▁uncle .	▁这 栋房子 属于 我的 叔叔 。
▁These ▁box es ▁are ▁heavy .	▁这些 箱子 是 重 的 。
▁My ▁grandfather ▁is ▁f ond ▁of ▁taking ▁a ▁walk ▁early ▁in ▁the ▁morning .	▁我的 爷爷 喜欢 大 清 早 的 散步 。
▁Tom ▁told ▁me ▁that ▁he ▁won ' t ▁come ▁to ▁school ▁tomorrow .	▁汤姆告诉我他 明天 不 来 上学 。
▁You ▁look ▁as ▁healthy ▁as ▁ever .	▁你看起来 健康 如 昔 。
▁You ▁can ▁go ▁anywhere ▁you ▁want .	▁你可以 去 任何 你想 去 的地方 。
▁I ' m ▁clearly ▁missing ▁something ▁here .	▁我 确实 在这里 丢了 东西 。
▁When ▁can ▁we ▁eat , ▁I ▁wonder .	▁我不知道 我们 什么时候 可以 吃 。
▁She ▁d rew ▁out ▁the ▁money ▁from ▁the ▁bank .	▁她从 银行 取 了 钱 。
▁We ▁are ▁leaving ▁Japan ▁next ▁month .	▁我们 下个月 将 离开 日本 。
▁I ▁arrived ▁at ▁N ar it a ▁A ir port ▁this ▁morning .	▁我今天早上 抵达 了 成 田 机场 。
▁I ▁heard ▁someone ▁come ▁in .	▁我听到 有人 进 来了 。
▁I ▁don ' t ▁quite ▁understand ▁what ▁he ▁says .	▁我不太 明白 他 说什么 。
▁Please ▁turn ▁off ▁the ▁TV .	▁请把 电视 关 掉 。
▁The ▁students ▁learned ▁many ▁po em s ▁by ▁heart .	▁ 学生 们 用 心 学习 了很多 首 诗 。
▁He ▁is ▁at ▁her ▁side .	▁他在 她的 旁边 。
▁Be ▁careful ▁not ▁to ▁catch ▁a ▁cold .	▁小心 不要 感冒了 。
▁Help ▁us ▁reach ▁our ▁goal .	▁ 帮助 我们 达 成 目标 。
▁I ' m ▁glad ▁I ▁could ▁help .	▁能 够 出 一份 力 太好了 。
▁Let ' s ▁get ▁divorced .	▁我们 离婚 吧 。
▁That ' s ▁the ▁computer ▁he ▁used ▁to ▁write ▁the ▁artic le .	▁那 就是 那 台 他 用来 写 文章 的 电脑 。
▁A ▁card ▁was ▁att ached ▁to ▁the ▁gift .	▁一 张 卡 片 被 附 在 了 礼物 上 。
▁If ▁you ▁want ▁a ▁pencil , ▁I ' ll ▁lend ▁you ▁one .	▁如果你 需要 铅笔 , 我 借 你 一支 。
▁The ▁well ▁ran ▁dry .	▁这 口 井 干 涸 了 。
▁The ▁apple ▁doesn ' t ▁fall ▁far ▁from ▁the ▁tree .	▁ 苹果 掉 落 的地方 不会 离 树 干 很远 。
▁Tom ▁won dered ▁why ▁Mary ▁was ▁crying .	▁汤姆 奇怪 为什么 玛丽 哭 。
▁A m ▁I ▁a ▁good ▁teacher ?	▁我 是一个好 老师 吗 ?
▁What ▁is ▁the ▁them e ▁of ▁his ▁l at est ▁novel ?	▁他 最后 一本 小说 的主 题 是什么 ?
▁We ' ve ▁spent ▁too ▁much ▁time ▁here .	▁我们 在这里 花了 太多 时间 。
▁The ▁ag es ▁of ▁the ▁two ▁children ▁put ▁together ▁was ▁equ iv al ent ▁to ▁that ▁of ▁their ▁father .	▁ 两个 孩子 的 年龄 加 起来 和 他们的 父亲 相当 。
▁There ' s ▁a ▁telephone ▁in ▁my ▁room .	▁我的 房 里有 部 电话 。
▁Not ▁a ▁single ▁person ▁arrived ▁late .	▁没有 一个人 迟到 。
▁He ▁cannot ▁afford ▁to ▁buy ▁a ▁car , ▁much ▁less ▁a ▁house .	▁他 买 不起 一辆 汽车 , 更 不要 说 一 套 房子 了 。
▁Tom ▁picked ▁up ▁the ▁j ar ▁and ▁read ▁the ▁l ab el .	▁汤姆 拿 起 罐 子 读 标 签 。
▁Tom ▁is ▁playing ▁the ▁violin ▁now .	▁汤姆 正在 拉 小提琴 。
▁The ▁man ▁ate ▁bread .	▁这个 男人 吃了 面包 。
▁We ▁couldn ' t ▁keep ▁from ▁crying .	▁我们 止 不 住 哭 泣 。
▁It ▁is ▁no ▁use ▁crying ▁over ▁sp ilt ▁milk .	▁ 为 溅 出 的 牛奶 哭 也没 用 。
▁Can ▁I ▁use ▁your ▁pen ?	▁我可以 用 你的 笔 吗 ?
▁We ▁should ▁study ▁English ▁every ▁day .	▁我们应该 每天都 学英语 。
▁She ▁sent ▁this ▁book ▁to ▁me .	▁她 寄 这本书 给我 。
▁This ▁city ▁is ▁cold ▁and ▁lonely ▁without ▁you .	▁没有 你 , 这 座 城市 寒 冷 又 孤 寂 。
▁I ▁might ' ve ▁forgot ten ▁my ▁keys .	▁我 可能 把 钥匙 忘了 。
▁He ▁gr as p ed ▁the ▁rope ▁with ▁two ▁hands .	▁他 用 两 只 手 抓 住了 绳子 。
▁He ▁spent ▁the ▁morning ▁reading ▁a ▁book .	▁他 整个 上午 都在 看书 。
▁In ▁case ▁of ▁fire , ▁p ush ▁the ▁button .	▁ 万 一 发生 火灾 , 按 下 按 钮 。
▁You ' ll ▁get ▁lost .	▁你会 迷路 的 。
▁Give ▁me ▁your ▁phone .	▁给我 你的 手机 。
▁F ish ▁is ▁cheap ▁today .	▁今天 鱼 很 便宜 。
▁F ill ▁it ▁up .	▁把 它 填 满 。
▁I ▁don ' t ▁like ▁novel s ▁without ▁he ro es .	▁我不喜欢 没有 英 雄 的 小说 。
▁It ' s ▁already ▁7 :00 .	▁已经 是 早上 七 点了 。
▁How ▁much ▁does ▁the ▁wood en ▁chair ▁cost ?	▁那 张 木 椅 要 多少钱 ?
▁He ▁told ▁me ▁to ▁do ▁it , ▁so ▁I ▁did ▁it .	▁他 让我 做 , 我就 做了 。
▁All ▁the ▁sign s ▁are ▁that ▁she ▁is ▁getting ▁better .	▁所有 迹 象 表 明 她 好 起来了 。
▁I ' ve ▁got ▁a ▁p ace m ak er .	▁我 装 了个 心 脏 起 搏 器 。
▁I ▁will ▁do ▁my ▁best .	▁我会 尽力 而为 。
▁You ▁have ▁to ▁follow ▁the ▁rules .	▁你必须 遵守 规则 。
▁We ▁enjoyed ▁watching ▁the ▁baseball ▁game .	▁我们喜欢 看 棒球 比赛 。
▁Why ▁did ▁you ▁marry ▁Tom ?	▁你为甚么 跟汤姆 结婚 ?
▁His ▁son ' s ▁cr im in al ▁act iv ities ▁ca used ▁him ▁great ▁pain .	▁他 儿子 的 犯 罪 行为 给他 带 来了 很大的 痛苦 。
▁I ▁don ' t ▁speak ▁Japanese .	▁我不 说 日语 。
▁" S he ▁likes ▁music ." ▁" S o ▁do ▁I ."	▁“ 她 喜欢 音乐 。”“ 我也 是 。”
▁You ▁can ▁no ▁longer ▁hurt ▁me .	▁你不 再 能 伤害 到我 了 。
▁She ▁r ushed ▁home ▁with ▁the ▁good ▁news .	▁她 急 忙 带 著 好 消息 跑 回家 。
▁There ' s ▁always ▁someone ▁talking .	▁ 总是 会 有人 谈论 。
▁I ' m ▁sorry . ▁I ▁got ▁the ▁wrong ▁number .	▁对不起 , 我 拿 错了 号码 。
▁Were ▁you ▁at ▁school ▁at ▁that ▁time ?	▁那 时 你 在 学校 吗 ?
▁Af raid ▁of ▁hur ting ▁his ▁feelings , ▁I ▁didn ' t ▁tell ▁him ▁the ▁truth .	▁ 怕 伤害 了他的 感 情 , 我没有 告诉他 真相 。
▁Please ▁return ▁the ▁book ▁by ▁tomorrow .	▁请 明天 前 还 书 。
▁That ▁doesn ' t ▁make ▁sense .	▁这 没有任何 意义 。
▁I ▁have ▁lot s ▁of ▁things ▁to ▁do .	▁我有 很多 事情 要做 。
▁There ' s ▁no ▁use ▁crying ▁over ▁sp ilt ▁milk .	▁ 为 打 翻 的 牛奶 而 哭 泣 是 没 用的 。
▁We ▁haven ' t ▁thought ▁about ▁it .	▁我们 还没 考虑 。
▁L ast ▁year ▁in ▁the ▁P h ili pp ines , ▁earthqu akes ▁and ▁t id al ▁w ave s ▁result ed ▁in ▁the ▁death s ▁of ▁more ▁than ▁6 ,000 ▁people .	▁去年 在 菲 律 宾 , 地震 和 海 啸 造 成了 超过 6 000 人的 死 亡 。
▁She ▁didn ' t ▁like ▁him .	▁她不喜欢 他 。
▁I ▁wish ▁you ▁could ▁have ▁been ▁there .	▁要 是你 能 在那里 就好了 。
▁Please ▁help ▁me .	▁请帮我 。
▁In ▁the ▁U . S . , ▁most ▁people ▁can ▁v ote ▁when ▁they ▁reach ▁eight een ▁years ▁of ▁age .	▁在 美国 , 大 多 数 人 能 在 十 八 岁 后 投 票 选 举 。
▁Tom ▁picked ▁up ▁a ▁pencil .	▁汤姆 拿 起 铅笔 。
▁Nobody ▁had ▁ever ▁heard ▁of ▁it .	▁ 以前 从来 没有人 听 说过 。
▁I ▁believe ▁that ▁story .	▁我相信 那个 故事 。
▁It ▁can ▁be ▁dangerous .	▁它 有 危险 。
▁He ▁will ▁reg ret ▁it ▁soon er ▁or ▁later .	▁他 迟 早 会 后悔 。
▁She ▁is ▁f ond ▁of ▁playing ▁tennis .	▁她 酷 爱 打网球 。
▁Excuse ▁me . ▁Do ▁you ▁speak ▁English ?	▁对不起 。 你会 讲英语 吗 ?
▁Can ▁Tom ▁buy ▁that ▁for ▁us ?	▁汤姆 能 给我们 买 吗 ?
▁He ▁is ▁looking ▁forward ▁to ▁it .	▁他对 此 很 期待 。
▁He ▁usually ▁went ▁to ▁bed ▁at ▁eleven .	▁他 通常 在 十 一点 上床 睡觉 。
▁I ▁know ▁life ▁is ▁short .	▁我知道 生命 是 短 暂 的 。
▁Where ▁did ▁it ▁come ▁from ?	▁它 从哪里 来 ?
▁Are ▁you ▁still ▁collect ing ▁stamps ?	▁你还 在 收集 邮票 吗 ?
▁I ▁will ▁never ▁see ▁him ▁again .	▁我永远不会 再 看到 他 。
▁I ▁went ▁shopping ▁last ▁Saturday .	▁上 周 六 我去 购物 。
▁I ▁like ▁my ▁coffee ▁without ▁su g ar .	▁我喜欢 喝 咖啡 不 加 糖 。
▁The ▁to we l ▁wasn ' t ▁useful ▁at ▁all .	▁ 毛 巾 完全 没 起 作 用 。
▁I ▁am ▁going ▁to ▁play ▁tennis .	▁我要 去 打网球 。
▁It ▁was ▁just ▁as ▁I ▁thought .	▁这 正 如 我想 的 一样 。
▁Tom ▁enjoy s ▁garden ing .	▁汤姆 享 受 园 艺 。
▁May ▁I ▁speak ▁to ▁you ▁a ▁minute ?	▁我可以 和你 讲 一下 话 吗 ?
▁It ▁is ▁up ▁to ▁you ▁to ▁decide ▁whether ▁we ▁will ▁go ▁there ▁or ▁not .	▁我们 去 不去 那儿 由 你来 决定 。
▁I ▁don ' t ▁even ▁want ▁to ▁think ▁about ▁what ▁could ▁happen .	▁我甚至 不想去 想 会发生 什么 。
▁I ▁heard ▁her ▁singing .	▁我听 见 她 唱歌 了 。
▁I ▁don ' t ▁want ▁to ▁grow ▁up .	▁我不想 长大 。
▁I ▁don ' t ▁go ▁to ▁school ▁by ▁bus .	▁我不 乘 公交 去学校 。
▁This ▁river ▁is ▁dangerous ▁for ▁children ▁to ▁swim ▁in .	▁ 孩子 在这 条 河里游泳 太 危险 了 。
▁The ▁pr ince ▁succeed ed ▁to ▁the ▁thr one .	▁ 王 子 继 承 了 王 位 。
▁I ▁feel ▁sad ▁every ▁now ▁and ▁then .	▁我常常 觉得 悲伤 。
▁He ' s ▁new ▁in ▁town .	▁他刚 来 这 镇上 。
▁That ▁g ent le man ▁usually ▁wears ▁a ▁hat .	▁那 位 绅 士 经常 戴 著 一 顶帽子 。
▁Tom ▁followed .	▁汤姆 跟着 。
▁It ' s ▁no ▁use ▁your ▁beg g ing ▁him ▁for ▁help .	▁你 求 他 帮忙 没有 用 。
▁A ▁glass ▁of ▁wine , ▁please .	▁一 杯 葡萄酒 , 谢谢 。
▁Do ▁you ▁think ▁we ▁should ▁send ▁for ▁the ▁doctor ?	▁你认为 我们 应该 派 人 去 请 医生 来吗 ?
▁The ▁rep or ter ▁cr itic ized ▁the ▁pol itic ian .	▁ 记 者 批 评 了 政治 家 。
▁O f ▁course .	▁当 然 了 。
▁I ▁didn ' t ▁tell ▁them .	▁我没 告诉 他们 。
▁Why ▁didn ' t ▁you ▁bring ▁your ▁hat ▁today ?	▁为什么你 今天 没有 把 帽子 带来 ?
▁Do ▁you ▁know ▁how ▁to ▁play ▁ma h j ong ?	▁你知道 怎么 打 麻 将 吗 ?
▁I ▁used ▁to ▁play ▁tennis .	▁我以前 打网球 。
▁What ▁did ▁Tom ▁expect ▁Mary ▁to ▁do ?	▁汤姆 打算 让 玛丽 做什么 ?
▁You ▁are ▁not ▁coming , ▁are ▁you ?	▁你 不会来 , 是吗 ?
▁What ▁did ▁you ▁find ▁out ?	▁你 发现了 甚么 ?
▁She ▁had ▁the ▁n erve ▁to ▁speak ▁out .	▁她有 胆 量 说 出来 。
▁He ▁has ▁an ▁eye ▁for ▁an t i qu es .	▁他对 古 董 很有 鉴 赏 力 。
▁B ear s ▁can ▁climb ▁trees .	▁ 熊 会 爬 树 。
▁Did ▁anyone ▁call ▁me ▁while ▁I ▁was ▁out ?	▁我 出去 的时候 有人 打 我 电话 吗 ?
▁My ▁brother ▁would ▁often ▁stay ▁up ▁all ▁night ▁reading ▁novel s .	▁我哥哥 经常 熬 夜 看 小说 。
▁I ▁don ' t ▁think ▁he ' ll ▁say ▁y es .	▁我不认为 他会 同意 。
▁I ▁waited ▁for ▁my ▁friend ▁for ▁an ▁hour .	▁我 等 我的 一个朋友 等 了一 小时 。
▁We ' ll ▁get ▁a ▁phone ▁call ▁from ▁him ▁tonight ▁for ▁sure .	▁今晚 我们 肯定 会 接 到 他的 电话 。
▁My ▁father ▁got ▁married ▁in ▁his ▁tw ent ies .	▁我父亲 在他 二十 多 岁 时 结婚了 。
▁Let ' s ▁just ▁eat .	▁我们 吃 吧 。
▁It ' s ▁only ▁a ▁matter ▁of ▁time .	▁这 只是 时间 的问题 。
▁He ▁doesn ' t ▁know ▁how ▁to ▁write ▁a ▁letter ▁in ▁English .	▁他 不知道 如何 用 英语 写信 。
▁I ▁still ▁don ' t ▁understand ▁what ' s ▁happen ing .	▁我 还是 不 明白 出 了什么 事 。
▁Have ▁you ▁been ▁eating ?	▁你在 吃东西 吗 ?
▁I ▁don ' t ▁know ▁if ▁you ▁feel ▁the ▁same ▁as ▁I ▁do .	▁我不知道 你 是否 和我 有一 样的 感觉 。
▁Could ▁we ▁have ▁a ▁table ▁outside ?	▁我们在 外面 可以 有一 张 桌子 吗 ?
▁They ' re ▁children .	▁他们是 孩子 。
▁He ▁graduated ▁from ▁Harvard ▁Un iversity ▁with ▁hon or s .	▁他 光 荣 地 从 哈佛 大学 毕业 了 。
▁He ▁was ▁acc used ▁of ▁mur der .	▁他被 控 告 杀 人 罪 。
▁She ' s ▁hid ing ▁the ▁truth ▁from ▁us .	▁她不 让我们 知道 真相 。
▁You ▁don ' t ▁get ▁up ▁as ▁early ▁as ▁your ▁sister , ▁do ▁you ?	▁你 比你 妹妹 起 得 晚 , 不是么 ?
▁Put ▁it ▁on ▁one ▁bill , ▁please .	▁请 记 在 一张 帐 单上 。
▁How ▁are ▁you ▁feeling ▁this ▁morning ?	▁你今天 早上 感觉 如何 ?
▁What ▁we ▁need ▁is ▁help .	▁我们需要 的是 帮助 。
▁Do ▁you ▁know ▁how ▁far ▁it ▁is ▁from ▁the ▁station ▁to ▁city ▁ha ll ?	▁你知道 从 火车站 到 市 政 府 有多 远 ?
▁Wait ▁here .	▁在这 等着 。
▁This ▁is ▁the ▁time ▁he ▁n orm ally ▁arrive s .	▁他 这个 时候 该 到了 。
▁We ▁ordered ▁too ▁much ▁food .	▁我们 点 太多 食物 了 。
▁They ▁called ▁in ▁a ▁doctor ▁because ▁the ▁child ▁was ▁ill .	▁他们 打电话 给 医生 因为 这个 孩子 生病了 。
▁I ▁hope ▁he ▁will ▁wait ▁for ▁me .	▁我希望 他会 等我 。
▁You ▁can ▁stay ▁here ▁till ▁the ▁snow ▁stop s .	▁你可以 在这里等 到 雪 停 。
▁Leave s ▁begin ▁to ▁fall ▁in ▁O ct ob er .	▁ 树 叶 在 十 月 开始 掉 落 下来 。
▁Tom ▁asked ▁for ▁Mary ' s ▁perm ission ▁to ▁leave ▁early .	▁汤姆 请 玛丽 允许 他 早 走 。
▁That ▁wasn ' t ▁my ▁int ention .	▁那 不是 我的 本 意 。
▁We ▁had ▁a ▁m ild ▁winter ▁last ▁year .	▁去年 冬天 很 暖 和 。
▁This ▁is ▁what ▁I ▁want .	▁这 就 是我 想要的 。
▁Father ▁always ▁says , ▁" D o ▁your ▁best ."	▁父亲 总是 说 " 你 尽力 而为 。"
▁I ▁wish ▁they ▁would ▁stop ▁fight ing .	▁我希望 他们 会 停止 战斗 。
▁They ▁made ▁me ▁cap tain .	▁他们 让我 当 了 队 长 。
▁This ▁is ▁small er ▁than ▁that .	▁这个 比 那个 更 小 。
▁I ' m ▁glad ▁that ▁I ▁didn ' t ▁buy ▁something ▁like ▁this .	▁我很高兴 没有 买 这样 的东西 。
▁Don ' t ▁show ▁your ▁face ▁around ▁here ▁again .	▁你 不要 再 出现 在这里 了 。
▁S ci entist s ▁haven ' t ▁found ▁a ▁c ure ▁for ▁cancer ▁yet .	▁ 科学家 们 还 没有 找到 癌症 的 治 疗 方法 。
▁Could ▁you ▁translate ▁this ▁sentence ?	▁你能 翻译 这个 句子 吗 ?
▁He ▁traveled ▁around ▁the ▁world .	▁他 周 游世界 各地 。
▁We ' ll ▁go ▁when ▁the ▁rain ▁stop s .	▁当 雨 停了 , 我们就 会去 。
▁He ▁always ▁gets ▁bu ll ied ▁at ▁school .	▁他在 学校 老 是 被 人 欺 负 。
▁The ▁talks ▁will ▁last ▁three ▁days .	▁这场 谈话 将 要 持续 三天 。
▁Do ▁you ▁usually ▁have ▁tea ▁for ▁breakfast ?	▁你 经常 早餐 喝 茶吗 ?
▁I ▁am ▁expect ing ▁a ▁letter ▁from ▁her .	▁我期待 她的 来信 。
▁No , ▁I ▁didn ' t ▁go .	▁不 , 我没 去 。
▁Tom ▁is ▁always ▁late .	▁汤姆 总是 迟到 。
▁We ▁lock ▁the ▁door ▁at ▁night .	▁我们 晚上 锁门 。
▁Tom ▁b ur st ▁into ▁tears .	▁汤姆 泪 流 满 面 。
▁I ▁said ▁I ▁would ▁make ▁her ▁happy .	▁我 说 我会 让她 幸福 的 。
▁I ▁can ▁play ▁Ch op in .	▁我会 弹 萧 邦 。
▁He ▁l aid ▁on ▁his ▁back .	▁他 仰 躺 。
▁They ' re ▁ ign or ing ▁me .	▁他们 不 理 我 。
▁There ▁was ▁only ▁one ▁w arden ▁on ▁duty ▁when ▁the ▁r iot ▁started .	▁ 暴 动 开始 时 只 有一 位 监狱 长 值 班 。
▁Mar ried ▁people ▁sometimes ▁wish ▁they ▁were ▁single .	▁ 已 婚 的人 有 时候 希望 他们 是 单 身 , 。
▁How ▁about ▁going ▁out ▁for ▁lunch ?	▁出去 吃午饭 怎样 ?
▁She ▁played ▁a ▁t une ▁on ▁the ▁piano .	▁她在 钢琴 上 弹 了一 首 曲 子 。
▁Water ▁free z es ▁at ▁z er o ▁deg rees ▁C el s i us .	▁水 在 摄 氏 零 度 时 结 冰 。
▁Tom ▁didn ' t ▁tell ▁me ▁the ▁truth .	▁汤姆没有 告诉我 实话 。
▁The ▁offer ▁is ▁too ▁good ▁to ▁be ▁turned ▁down .	▁ 此 提议 好 得 令人 难以 拒绝 。
▁I ▁missed ▁you .	▁我想你 。
▁I ▁have ▁to ▁say ▁no .	▁我必须 拒绝 。
▁I ▁would ▁like ▁to ▁speak ▁English ▁flu ently .	▁我想 把 英语 说得很 流利 。
▁I ▁have ▁absolut e ▁trust ▁in ▁you .	▁我 绝对 信任 你 。
▁Tom ' s ▁dog ▁bit ▁him ▁play fully .	▁汤姆的 狗 咬 他 玩 。
▁Don ' t ▁und erest im ate ▁my ▁p ower .	▁不要 低 估 我的 力 量 。
▁Sorry ▁to ▁have ▁kept ▁you ▁waiting .	▁对不起 让你 一直 等 。
▁Which ▁one ▁will ▁he ▁choose ?	▁他会 选 哪个 ?
▁You ▁make ▁me ▁feel ▁so ▁gu il ty .	▁你 让我 感到很 内 疚 。
▁What ▁color ▁is ▁your ▁new ▁car ?	▁你的 新车 是甚么 颜 色的 ?
▁It ' s ▁pretty ▁simple .	▁它 真 简单 。
▁H ope fully , ▁we ' ll ▁enjoy ▁our ▁China ▁trip .	▁希望 我们 会 喜欢 我们的 中国 之 旅 。
▁She ▁is ▁very ▁thought ful ▁and ▁patient .	▁她 非常 周 到 和 耐心 。
▁The ▁arm y ▁for ced ▁him ▁to ▁res ign .	▁ 军 队 强 迫 他 辞职 。
▁I ▁was ▁surprised ▁to ▁see ▁a ▁li on .	▁我很 惊讶 竟 然 看到了 狮 子 。
▁Give ▁me ▁the ▁same , ▁please .	▁请给我 同 样 的东西 。
▁The ▁prize ▁won ' t ▁be ▁given ▁to ▁her .	▁ 奖 项 是 不会 授 给 她的 。
▁W ire s ▁are ▁used ▁to ▁con ve y ▁electric ity .	▁ 电 线 被 用来 运 送 电 力 。
▁I ' ve ▁been ▁want ing ▁to ▁see ▁you .	▁我一直 想 见你 。
▁I ▁wonder ▁how ▁many ▁Canad ians ▁live ▁in ▁Boston .	▁我在 想 有 多少 加拿大 人 住在波士顿 。
▁I ron ▁the ▁inside ▁of ▁coll ars ▁first , ▁and ▁then ▁the ▁outside .	▁ 先 熨 烫 领 子 的 里面 , 然后 是 外面 。
▁He ▁likes ▁oranges .	▁他喜欢 橙子 。
▁I ▁ran ▁as ▁fast ▁as ▁possible ▁to ▁catch ▁up ▁with ▁him .	▁我 尽力 追 赶 他 。
▁Everyone ▁adm ired ▁his ▁cour age .	▁每个人都 佩 服 他的 勇 气 。
▁I ▁still ▁haven ' t ▁found ▁work .	▁我还 没有 找到 工作 。
▁I ▁don ' t ▁know ▁who ▁made ▁the ▁cake .	▁我不知道 这个 蛋糕 是谁 做的 。
▁I ▁couldn ' t ▁understand ▁him ▁at ▁first .	▁起 初 我 听 不懂 他说的话 。
▁His ▁memory ▁never ▁ce as es ▁to ▁a st on ish ▁me .	▁他的 记忆 力 总 让我 吃惊 。
▁None ▁of ▁them ▁could ▁understand ▁what ▁she ▁was ▁imp ly ing .	▁他们 没有人 了解 她 暗 示 什么 。
▁He ▁was ▁paid ▁10 ,000 ▁dollars .	▁有人 付 给他 100 00 美元 。
▁Tell ▁me ▁what ▁to ▁do ▁with ▁it .	▁告诉我 拿 它 做什么 。
▁I ' ll ▁rec ons ider ▁the ▁matter .	▁我会 重 新 考虑 此 事 。
▁He ▁is ▁afraid ▁of ▁sn akes .	▁他怕 蛇 。
▁What ' s ▁your ▁mar ital ▁st at us ?	▁能 告诉我 你的 婚 姻 状 况 吗 ?
▁He ▁likes ▁hun ting .	▁他喜欢 打 猎 。
▁It ▁seems ▁that ▁Tom ▁is ▁lying .	▁看来 汤姆 在 说谎 。
▁She ' s ▁about ▁the ▁same ▁age ▁as ▁I ▁am .	▁她 大约 跟我 同 年纪 。
▁Tom ▁didn ' t ▁know ▁what ▁he ' d ▁say ▁to ▁Mary .	▁汤姆不知道 他 要 对 玛丽 说 甚么 。
▁Put ▁some ▁more ▁wood ▁on ▁the ▁fire .	▁再 往 火 里 添 些 木 柴 。
▁He ▁bought ▁his ▁daughter ▁a ▁new ▁dress .	▁他 买了 新 衣服 给他的 女儿 。
▁The ▁job ▁offer ▁still ▁stand s .	▁这 份工作 录 取 仍然 有 效 。
▁I ▁prov ided ▁him ▁with ▁food .	▁我 提供 了他 食物 。
▁A ▁friend ' s ▁coming ▁over ▁tomorrow .	▁一个 朋友 明天 要 过来 。
▁Give ▁it ▁to ▁them .	▁把 它 给 他们 。
▁The ▁f ile ▁is ▁cor rup t .	▁ 文件 已 损 坏 。
▁Have ▁you ▁had ▁your ▁eyes ight ▁check ed ▁recently ?	▁你 最近 检查 视力 了吗 ?
▁I ' ll ▁help ▁you ▁esc ape .	▁我会 帮你 逃 跑 的 。
▁I ▁think ▁I ' ll ▁go ▁by ▁bus .	▁我认为 我要 坐 巴士 去 。
▁She ▁married ▁a ▁music ian .	▁她 和 一位 音乐 家 结 了 婚 。
▁Some ▁people ▁don ' t ▁know ▁that .	▁有些人 不知道 那件事 。
▁English ▁is ▁used ▁by ▁many ▁people .	▁英语 是 被 许多 人 使用 。
▁There ▁is ▁a ▁cottage ▁be y ond ▁the ▁bridge .	▁ 桥 对面 有一 间 小屋 。
▁What ▁were ▁you ▁doing ▁in ▁the ▁att ic ?	▁你在 阁 楼 上 做了什么 ?
▁I ▁thought ▁that ▁he ▁would ▁come .	▁我以为 他 会来 的 。
▁She ▁said ▁she ▁had ▁a ▁cold .	▁她 说她 感冒了 。
▁The ▁baby ▁cried ▁all ▁night .	▁这 孩子 哭 了一 整夜 。
▁This ▁room ▁has ▁air ▁cond ition ing .	▁这个 房间 有空 调 。
▁Maybe ▁they ▁have ▁something .	▁他们 可能 有点 什么 。
▁He ▁gave ▁the ▁same ▁answer ▁as ▁before .	▁他 给了 跟 以前 一样 的 回答 。
▁Tom ▁didn ' t ▁have ▁a ▁fever ▁this ▁morning .	▁汤姆 今天 早上 没有 发烧 。
▁You ▁can ▁do ▁whatever ▁you ▁want ▁to .	▁你可以 做 任何 你想 做的事 。
▁Keep ▁it ▁in ▁a ▁c ool ▁place .	▁ 保 存在 阴 凉 的地方 。
▁The ▁date ▁of ▁the ▁f est iv al ▁co inc ides ▁with ▁that ▁of ▁the ▁exam .	▁ 节 日 和 考试 碰 巧 在 同 一天 。
▁He ▁may ▁not ▁be ▁happy .	▁他可能 不高兴 。
▁The ▁horse ▁is ▁a ▁useful ▁anim al .	▁ 马 是 种 很有 用的 动物 。
▁How ▁long ▁would ▁it ▁take ?	▁要 多长时间 ?
▁Would ▁you ▁mind ▁saying ▁that ▁once ▁more ?	▁请你 再 说 一次 好吗 ?
▁I ' m ▁glad ▁to ▁make ▁your ▁acqu ain t ance .	▁我很高兴 能够 认识 您 。
▁Sh ut ▁the ▁door , ▁please .	▁请 关门 。
▁He ▁is ▁no ▁longer ▁a ▁boy .	▁他不 再 是个 男孩 。
▁No ▁words ▁can ▁exp ress ▁her ▁deep ▁s orrow .	▁她的 悲伤 无法 言 喻 。
▁I ' m ▁reading ▁a ▁novel ▁by ▁S id ney ▁She ld on .	▁我在 读 一本 西 德 尼 谢 尔 顿 写的 小说 。
▁Money ▁takes ▁a ▁long ▁time ▁to ▁ear n , ▁but ▁you ▁can ▁spend ▁it ▁in ▁no ▁time .	▁ 钱 要花 很长 的时间 来 赚 , ▁但 你可以 一下 子 就 花 掉 它了 。
▁She ▁was ▁almost ▁late ▁for ▁school .	▁她 上学 几乎 迟到 。
▁How ▁many ▁people ▁can ▁do ▁that ?	▁有 多少 人 能 做 ?
▁I ▁lost ▁my ▁camera ▁the ▁other ▁day .	▁那 天 我 丢了我的 照相机 。
▁The ▁train ▁has ▁arrived .	▁这 班火车 已经 到了 。
▁What ▁are ▁you ▁concerned ▁about ?	▁你在 担心 什么 呢 ?
▁We ▁have ▁your ▁size , ▁but ▁not ▁in ▁that ▁color .	▁我们有 你的 尺 寸 , 但是 没有 那个 颜色 。
▁Why ▁did ▁you ▁come ▁here ▁this ▁morning ?	▁今天早上 你 为什么 来这里 ?
▁Can ▁you ▁come ▁to ▁the ▁meeting ▁tomorrow ?	▁你明天 可以 来 参加会议 吗 ?
▁We ▁can ▁come ▁to ▁visit ▁you .	▁我们 会来 拜访 你 。
▁If ▁two ▁men ▁always ▁have ▁the ▁same ▁opinion , ▁one ▁of ▁them ▁is ▁un n e cessary .	▁如果 两个 人 总是 意见 相同 , 那么 他们 其中 一个 就 没 必要 了 。
▁People ▁can ' t ▁keep ▁quiet .	▁人们 无法 保持 沉默 。
▁Is ▁there ▁cent ral ▁he ating ▁in ▁this ▁building ?	▁这 栋 楼 里面 有 中 央 暖 气 系 统 吗 ?
▁I ▁think ▁that ▁she ▁knows ▁the ▁truth .	▁我觉得 她 知道 真相 。
▁A ▁fe m a le ▁friend ▁of ▁mine ▁loves ▁to ▁go ▁to ▁g ay ▁b ars ▁with ▁me .	▁我的 一个 女 性 朋友 喜欢 跟我 一起去 同 志 酒 吧 。
▁I ▁am ▁going ▁to ▁major ▁in ▁French .	▁我将 主修 法 文 。
▁I ▁found ▁her ▁letter ▁in ▁the ▁mail bo x .	▁我在 信 箱 中 发现 了她的 信 。
▁That ▁changed ▁everything .	▁那 改变 了一 切 。
▁Tom ▁can ▁run ▁fast .	▁Tom 可以 跑 得很 快 。
▁Did ▁Tom ▁ever ▁tell ▁you ▁how ▁he ▁first ▁met ▁Mary ?	▁汤姆 告诉你 他是 怎样 第一次 遇见 玛丽的 了吗 ?
▁I ▁feel ▁sad ▁every ▁now ▁and ▁then .	▁我不 时 地 觉得 难 过 。
▁I ▁like ▁tea .	▁我喜欢 茶 。
▁Y es . ▁That ' s ▁right .	▁是 的 。 没 错 。
▁You ▁have ▁to ▁turn ▁in ▁the ▁report s ▁on ▁Monday .	▁ 星期一 你必须 缴 交 报告 。
▁You ▁must ▁hurry ▁up .	▁您 要 赶 快 些 。
▁She ▁found ▁a ▁job ▁as ▁a ▁typ ist .	▁她 找到 了一 份 打 字 员 的工作 。
▁Tom ▁is ▁really ▁hands ome .	▁汤姆 真 帅 。
▁Everyone ▁is ▁here ▁except ▁for ▁him .	▁除 了他 每个人都 在这里 。
▁My ▁older ▁brother ▁is ▁a ▁teacher .	▁我哥哥 是一名 教师 。
▁They ▁live ▁in ▁peace .	▁他们 过 着 和平 的 生活 。
▁Don ' t ▁forget ▁us .	▁别 忘了 我们 。
▁I ▁always ▁have ▁two ▁cup s ▁of ▁coffee ▁in ▁the ▁morning .	▁我 早 晨 总是 喝 两 杯 咖啡 。
▁It ' s ▁just ▁your ▁imag ination .	▁这 只是 你的 想象 。
▁I ▁asked ▁him ▁for ▁a ▁favor .	▁我请 他 帮忙 。
▁My ▁sister ▁is ▁taller ▁than ▁my ▁brother .	▁我 姐姐 比我 哥哥 大 。
▁I ' m ▁a ▁teacher .	▁我是个 老师 。
▁He ▁has ▁no ▁sense ▁of ▁right ▁and ▁wrong .	▁他是 非 不 分 。
▁That ' s ▁right !	▁对 了 !
▁I ▁seem ▁to ▁have ▁a ▁fever .	▁我 好像 发烧 了 。
▁Everyone ▁in ▁her ▁class ▁likes ▁her .	▁她 班 上的 每个人都 喜欢 她 。
▁Our ▁baseball ▁team ▁is ▁very ▁strong .	▁我们的 棒球 队 很 强 。
▁He ▁threw ▁a ▁stone ▁into ▁the ▁pond .	▁他 扔 一 块 石头 到 池塘 里 。
▁This ▁is ▁a ▁very ▁important ▁meeting .	▁这是个 很重要 的 会议 。
▁To ▁the ▁man ▁who ▁only ▁has ▁a ▁ha mmer ▁in ▁the ▁too l k it , ▁every ▁problem ▁looks ▁like ▁a ▁n ail .	▁对 工 具 箱 里 只 有一 把 榔 头 的人 来说 , 所有的 问题 都 像 钉 子 。
▁How ▁many ▁times ▁a ▁day ▁do ▁you ▁look ▁at ▁yourself ▁in ▁the ▁mir ror ?	▁你 一天 照 几 次 镜 子 ?
▁Tom ▁got ▁out ▁of ▁the ▁taxi .	▁汤姆从 出租车 上 下来了 。
▁He ▁asked ▁that ▁we ▁be ▁sil ent .	▁他 要求 我们 安静 。
▁Tom ▁is ▁doing ▁what ▁he ▁loves .	▁汤姆在 做 他 喜欢 做的事 。
▁I ▁can ▁play ▁soccer .	▁我会 踢足球 。
▁Don ' t ▁speak ▁to ▁anyone .	▁你们 别 和 任何人 说 。
▁I ▁saw ▁it ▁with ▁my ▁own ▁eyes .	▁我 亲 眼 看见 了 。
▁You ▁have ▁to ▁be ▁patient .	▁你必须 有 耐心 。
▁She ▁walks .	▁她在 行 走 。
▁It ' s ▁too ▁long .	▁它 太 长 了 。
▁You ▁and ▁I ▁have ▁something ▁in ▁common .	▁你 和我 有一些 共 同 点 。
▁A ▁p an el ▁of ▁exper ts ▁discuss ed ▁the ▁plan .	▁一个 专 家 小 组 讨论 这个计划 。
▁Are ▁you ▁listening ▁to ▁English ?	▁你在 听 英语 吗 ?
▁He ▁pl aced ▁the ▁book ▁on ▁the ▁shelf .	▁他把 书放在 了 书架上 。
▁" W hat ▁time ▁is ▁it ?" ▁" It ▁is ▁ten - thirty ."	▁" 几 点了 ?" " 10 点半 了 。"
▁I ▁don ' t ▁want ▁to ▁eat ▁lunch ▁now .	▁我现在 不想 吃午饭 。
▁Tom ▁is ▁in ▁the ▁living ▁room .	▁汤姆在 起 居 室 里 。
▁She ▁almost ▁passed ▁out .	▁她 几乎 喝 晕 了 。
▁How ▁much ▁time ▁is ▁left ?	▁还 剩 多少 时间 ?
▁I ▁don ' t ▁have ▁to ▁clean ▁my ▁room .	▁我不 用 打扫 房间 。
▁I ' ve ▁been ▁on ▁vacation .	▁我在 休 假 。
▁The ▁meeting ▁ended .	▁会议 结束了 。
▁I ▁haven ' t ▁eaten ▁anything ▁since ▁yesterday .	▁我从 昨天 起 没有 吃 任何东西 。
▁We ▁need ▁an ▁amb ul ance .	▁我们需要 一辆 救 护 车 。
▁I ▁would ▁do ▁it ▁if ▁I ▁could .	▁我 如果 能 做 就 做了 。
▁I ▁would ▁like ▁to ▁have ▁a ▁look ▁at ▁your ▁collect ion ▁of ▁stamps .	▁我想 看看 您的 邮票 收 藏 。
▁I ▁was ▁to t ally ▁confused .	▁我完全 不懂 了 。
▁H app y ▁New ▁Y ear !	▁ 新 年 快乐 !
▁This ▁is ▁the ▁best ▁pizza ▁I ' ve ▁ever ▁eaten .	▁这是我 吃过 的 最好的 比萨 。
▁I ' m ▁opp osed ▁to ▁any ▁type ▁of ▁war .	▁我 反对 任何 形 式 的 战争 。
▁P ric es ▁are ▁d ouble ▁what ▁they ▁were ▁two ▁years ▁ago .	▁ 价格 是 两 年前 的 两 倍 。
▁You ' ll ▁get ▁used ▁to ▁this ▁in ▁three ▁or ▁four ▁week s .	▁你在 三 或 四 周 内 会 习惯 这个 。
▁He ▁will ▁be ▁back ▁tomorrow .	▁明天 他会 回来 。
▁What ' s ▁the ▁weather ▁like ?	▁天气 怎么样 ?
▁They ▁forg ave ▁him ▁for ▁his ▁cr imes .	▁他们 原谅 了他的 罪 行 。
▁Sh ort ly ▁after ▁the ▁accident , ▁the ▁police ▁came .	▁事故 发生 后 不 久 , 警察 来了 。
▁She ▁eats ▁nothing ▁but ▁vegetables .	▁她 只 吃 蔬菜 。
▁Tom ▁played ▁with ▁his ▁dog .	▁汤姆 和他的 狗 玩 。
▁Can ▁you ▁wait ▁about ▁an ▁hour ?	▁能 麻烦 您 等 一个 小时 左右 吗 ?
▁It ' s ▁a ▁good ▁start .	▁这是一个 好的 开 端 。
▁The ▁problem ▁is , ▁he ▁has ▁no ▁money .	▁问题 是他 没 钱 。
▁I ▁do ▁forg ive ▁Tom .	▁我真的 原谅 汤姆 。
▁His ▁ideas ▁are ▁always ▁pract ical .	▁他的 主意 总是 可 行 的 。
▁You ' re ▁not ▁even ▁pay ing ▁attention .	▁你 根本 没有 注意 。
▁Keep ▁Tom ▁safe .	▁ 确 保 汤姆 安全 。
▁The ▁well ▁has ▁run ▁dry .	▁这 口 井 干 涸 了 。
▁Tom ▁was ▁so b b ing .	▁汤姆在 啜 泣 。
▁Give ▁me ▁something ▁to ▁do .	▁给我 点 事 做 。
▁Should n ' t ▁Tom ▁be ▁doing ▁this , ▁too ?	▁Tom 也 需要 做这 件事 吗 ?
▁Everybody ▁knows ▁his ▁name .	▁每个人都 知道 他的名字 。
▁I ▁got ▁a ▁good ▁night ' s ▁sleep .	▁我 睡 了个 好 觉 。
▁I ' m ▁afraid ▁you ▁have ▁the ▁wrong ▁number .	▁我 恐怕 您 打 错 电话 了 。
▁The ▁old ▁man ▁passed ▁away ▁this ▁morning .	▁ 老 男人 今天 早上 去世了 。
▁Children ▁need ▁a ▁lot ▁of ▁sleep .	▁孩子们 需要 大量 的 睡 眠 。
▁Turn ▁the ▁fl ame ▁down ▁low .	▁把 火 转 小 一点 。
▁That ' s ▁very ▁hand y .	▁这 很 方便 。
▁Maybe ▁that ▁won ' t ▁happen .	▁也许 那 没有 发生 。
▁She ▁refused ▁to ▁accept ▁the ▁money .	▁她 拒绝 接受 这 笔钱 。
▁I ▁don ' t ▁need ▁you ▁or ▁anybody ▁else .	▁我不 需要 你 或 别 的人 。
▁Tom ▁was ▁a ▁nurse .	▁汤姆是个 护士 。
▁Just ▁take ▁my ▁word ▁for ▁it .	▁请 相信 我的 话 。
▁This ▁is ▁the ▁end .	▁这是 结束 。
▁He ▁finally ▁became ▁the ▁president ▁of ▁I B M .	▁他 最终 成了 I B M 的 总 裁 。
▁Mary ▁has ▁just ▁come ▁home .	▁玛丽 刚 刚 回家 。
▁My ▁mother ▁is ▁busy ▁in ▁the ▁kitchen .	▁我的 母亲 在 厨房 里 正 忙著 。
▁Do ▁you ▁believe ▁in ▁ghosts ?	▁你相信 有 幽 灵 吗 ?
▁A ▁bird ▁in ▁the ▁hand ▁is ▁worth ▁two ▁in ▁the ▁bus h .	▁一 鸟 在 手 胜过 二 鸟 在 林 。
▁All ▁you ▁can ▁do ▁is ▁to ▁wait .	▁所有 你能 做的 就是 等待 。
▁Tom ▁can ' t ▁go ▁home ▁until ▁after ▁2 :30 .	▁汤姆在 2 :30 之后 才能 回家 。
▁The ▁cl own ▁made ▁a ▁fun ny ▁face .	▁小 丑 做了 个 鬼 脸 。
▁I ▁have ▁lost ▁my ▁watch .	▁我把我的 表 丢了 。
▁I ▁wish ▁I ▁had ▁a ▁car .	▁但愿我 有一 辆车 。
▁He ▁couldn ' t ▁wait ▁to ▁try ▁out ▁his ▁new ▁sur f bo ard .	▁他 迫 不 及 待 地 想 试 一下 他的 新 冲 浪 板 。
▁I ▁have ▁to ▁call ▁Tom .	▁我得 给汤姆 打电话 。
▁I ▁can ' t ▁believe ▁you ' re ▁giving ▁up .	▁我不能 相信你 在 放弃 。
▁Please ▁ask ▁at ▁the ▁information ▁desk .	▁请 向 服务 台 询 问 。
▁What ▁do ▁you ▁plan ▁to ▁sell ?	▁你 计划 卖 甚么 ?
▁You ▁may ▁not ▁come ▁in .	▁你不能 进来 。
▁Her ▁only ▁pleasure ▁is ▁listening ▁to ▁music .	▁她 唯一 的 乐 趣 就是 听音乐 。
▁A ▁bird ▁in ▁the ▁hand ▁is ▁better ▁than ▁two ▁in ▁the ▁bus h .	▁一 鸟 在 手 胜过 二 鸟 在 林 。
▁My ▁aunt ▁gave ▁me ▁a ▁camera .	▁我的 阿姨 给了我 一 台 摄 影 机 。
▁I ▁could ▁hardly ▁keep ▁from ▁laugh ing .	▁我 忍 不 住 要 大 笑 。
▁Put ▁your ▁hands ▁up !	▁ 手 举 起来 。
▁Per fect !	▁ 完美 !
▁Everyone ▁wants ▁what ▁they ▁can ' t ▁have .	▁每个人都 想要 得到 无法 拥有 的东西
▁He ▁studies ▁Chinese ▁as ▁well .	▁他 也 学习 汉 语 。
▁Don ' t ▁you ▁want ▁to ▁know ▁the ▁reason ?	▁你不 想知道 原因 吗 ?
▁Where ▁can ▁we ▁make ▁a ▁phone ▁call ?	▁我们能 在哪里 打电话 ?
▁I ▁am ▁studying ▁now .	▁我现在 正在 学习 。
▁He ▁was ▁in ▁America ▁at ▁that ▁time .	▁他 当时 在 美国 。
▁There ▁is ▁one ▁apple ▁on ▁the ▁desk .	▁ 书桌 上有 一个 苹果 。
▁Where ' s ▁my ▁father ?	▁我父亲 在哪里 ?
▁I ▁took ▁him ▁to ▁the ▁most ▁expensive ▁restaurant ▁on ▁cam p us .	▁我把 他 带 到 校 区 里 最 贵 的 餐馆 去了 。
▁I ▁just ▁knew ▁you ▁would ▁say ▁that .	▁我 就 知道 你会 这么 说 。
▁Th row ▁the ▁ball ▁back ▁to ▁me .	▁把 球 丢 还 给我 。
▁You ▁have ▁a ▁really ▁good ▁sense ▁of ▁dire ction .	▁你的 方 向 感 很好 。
▁Tom ▁wants ▁to ▁tell ▁you ▁something .	▁汤姆想 告诉你 一些 事情 。
▁Tom ▁took ▁Fr iday ▁off .	▁汤姆 星期 五 闲 着 。
▁This ▁t ape ▁rec or der ▁is ▁not ▁new .	▁这个 磁 带 录 音机 不是 新的 。
▁Has ▁anything ▁changed ?	▁有 任何 事情 改变 了吗 ?
▁When ▁did ▁she ▁promise ▁to ▁meet ▁him ?	▁她 答应 几 时 见 他 ?
▁The ▁students ▁all ▁laughed .	▁ 学生 都 笑了 。
▁Don ' t ▁be ▁cr ue l ▁to ▁animals .	▁不要 虐 待 动物 。
▁He ▁knows ▁a ▁lot ▁about ▁foreign ▁aff airs .	▁他 知道 很多 外国 事 务 。
▁Tom ▁works ▁in ▁Boston .	▁汤姆在 波士顿 工作 。
▁Please ▁help ▁yourself ▁to ▁the ▁fruit .	▁请 随 意 吃 水果 。
▁Her ▁mother ▁passed ▁away ▁last ▁year .	▁她的 母亲 去年 去世了 。
▁I ▁like ▁to ▁go ▁fishing ▁with ▁my ▁father .	▁我喜欢 和 父亲 一起去 钓鱼 。
▁You ▁should ▁put ▁your ▁coat ▁on .	▁你应该 把 大衣 穿 上 。
▁H op ▁in .	▁ 跳 进来 。
▁Tom ▁is ▁the ▁one ▁I ▁want .	▁汤姆 是我 想要 的人 。
▁They ▁built ▁a ▁bridge ▁across ▁the ▁river .	▁他们 建 了一 座 横 跨 河 流 的 桥 。
▁It ▁is ▁an ▁end ange red ▁spe c ies .	▁这是一个 濒 临 消 失 的 物 种 。
▁If ▁you ' re ▁busy , ▁I ' ll ▁help ▁you .	▁如果你 忙 , 我会 帮你 。
▁I ▁don ' t ▁care ▁for ▁eggs .	▁我不喜欢 鸡蛋 。
▁Who ' s ▁the ▁woman ▁in ▁the ▁b row n ▁coat ?	▁那个 穿 棕 色 大衣 的女人 是谁 ?
▁She ▁went ▁there ▁yesterday .	▁她昨天 去那里 。
▁I ▁will ▁bad ly ▁miss ▁you ▁if ▁you ▁leave ▁Japan .	▁如果你 离开 日本 , 我会 非常 想 你的 。
▁Can ▁you ▁name ▁one ▁of ▁their ▁songs ?	▁你能 够 说 出 一 首 他们的 歌 的名字 吗 ?
▁I ' ll ▁miss ▁your ▁cooking .	▁我会 想念 你的 厨 艺 。
▁That ' s ▁a ▁good ▁idea .	▁那 是一个好 主意 。
▁On ce ▁again .	▁再 一次 。
▁I ▁really ▁need ▁a ▁drink ▁now .	▁我现在 真 需要 来 杯 喝 的 。
▁What ▁if ▁Tom ▁is ▁still ▁alive ?	▁如果 汤姆 还 活着 呢 ?
▁You ▁need ▁a ▁vacation .	▁你需要 个 假 期 。
▁A ▁Japanese ▁wouldn ' t ▁do ▁such ▁a ▁thing .	▁日本 人 不会 做这 种 事 。
▁Those ▁apples ▁are ▁big .	▁那些 苹果 很大 。
▁Tom ▁wrote ▁two ▁books .	▁汤姆 写了 两 本书 。
▁I ▁have ▁things ▁to ▁take ▁care ▁of .	▁我有 些 事 。
▁The ▁top ▁of ▁Mt . ▁Fuji ▁was ▁covered ▁with ▁snow .	▁ 富士山 顶 盖 满了 雪 。
▁I ▁was ▁expect ing ▁it !	▁我一直 在 期待 着 !
▁His ▁voice ▁is ▁pleas ant ▁to ▁listen ▁to .	▁他的 声音 听 着 很 舒服 。
▁He ▁kept ▁a ▁di ary ▁during ▁the ▁trip .	▁他 旅行 期 间 , 写了 旅游 日 记 。
▁I ▁want ▁to ▁marry ▁a ▁girl ▁like ▁her .	▁我想 和 一个 像 她 那样 的女孩 结婚 。
▁I ▁had ▁no ▁idea ▁it ▁would ▁put ▁you ▁to ▁so ▁much ▁trouble .	▁我 一点 都 不知道 这 会 给你 带来 那么多 问题 。
▁Leave ▁the ▁room ▁immediately .	▁ 马上 离开 房间 。
▁Mon ke ys ▁can ▁learn ▁a ▁lot ▁of ▁tr ick s .	▁ 猴子 能 学会 很多 把 戏 。
▁Tom ▁thinks ▁there ' s ▁hope .	▁汤姆 认为 有 希望 。
▁I ▁got ▁home ▁at ▁seven .	▁我 七点 回 到家 。
▁The ▁cab ▁driver ▁wasn ' t ▁serious ly ▁injured .	▁ 出租车 司 机 没有 受 重 伤 。
▁I ▁don ' t ▁have ▁the ▁address ▁now .	▁我没有 现在 的 地址 。
▁This ▁time ▁it ' s ▁different .	▁这 次 不一样 。
▁She ▁will ▁be ▁se vent een ▁next ▁year .	▁她 明年 将 满 十 七 岁 。
▁I ▁want ▁my ▁dinner ▁brought ▁to ▁my ▁room .	▁我想要 我的 晚餐 送 到 房间里 来 。
▁I ▁wonder ▁what ▁I ▁should ▁do ▁today .	▁我在 想 我 今天 该 干什么 。
▁Tom ▁most ly ▁kept ▁to ▁himself .	▁汤姆 大 多 一个人 独 处 。
▁Where ▁do ▁you ▁watch ▁television ?	▁您 在哪儿 看电视 ?
▁Who ' s ▁the ▁man ▁playing ▁the ▁violin ?	▁那个 正在 拉 小提琴 的男人 是谁 ?
▁Nothing ▁ever ▁makes ▁him ▁angry .	▁没有 什么事 曾 让他 愤 怒 。
▁Tom ▁has ▁a ▁beautiful ▁car .	▁Tom 有 台 靓 车 。
▁Does ▁she ▁like ▁oranges ?	▁她喜欢 柳橙 吗 ?
▁You ▁may ▁go ▁anywhere ▁you ▁like .	▁你喜欢 去哪儿 就 可以 去哪儿 。
▁I ▁was ▁absent ▁from ▁work ▁yesterday .	▁我昨天 没 去上班 。
▁The ▁air ▁cond ition er ▁has ▁got ▁out ▁of ▁order .	▁ 空 调 坏了 。
▁I ▁always ▁keep ▁a ▁dictionary ▁close ▁at ▁hand .	▁我总是 在 离 手 不 远 的地方 放 一本 字典 。
▁I ▁think ▁I ▁lost ▁my ▁keys .	▁我觉得 我 把 钥匙 丢了 。
▁Are ▁you ▁reading ▁an ▁interesting ▁book ?	▁你在 读 有趣的 的书 吗 ?
▁She ▁g reet ed ▁me ▁with ▁a ▁smile .	▁她用 一个 微笑 迎 接 了我 。
▁May ▁I ▁eat ▁this ▁orange ?	▁我可以 吃 这个 柳橙 吗 ?
▁C ities ▁are ▁exc it ing ▁pl aces , ▁but ▁also ▁st ress ful .	▁ 城市 是 令人 兴奋 的地方 , 但 也 会 让 人 产 生 压 力 。
▁Everyone , ▁say ▁che ese .	▁所有 人 , 都 请 说 ▁che ese ▁ 。
▁I ▁don ' t ▁think ▁that ▁it ' s ▁necessary .	▁我想 没 这个 必要 。
▁You ' re ▁a ▁real ▁friend .	▁你 是个 真正 的朋友 。
▁I ▁know ▁him ▁by ▁sight , ▁but ▁not ▁by ▁name .	▁我知道 他的 样子 , 但 不知道 他的名字 。
▁She ▁had ▁the ▁n erve ▁to ▁speak ▁out .	▁她 竟 敢 说 出来 。
▁He ▁is ▁not ▁very ▁good ▁at ▁mathematics .	▁他不是 很 擅长 数学 。
▁I ▁didn ' t ▁even ▁consider ▁that .	▁我甚至 没 考虑 过 。
▁Where ▁is ▁the ▁tour ist ▁information ▁office ?	▁ 游 客 咨 询 处 在哪里 ?
▁Is ▁this ▁your ▁car ?	▁这是你的 车吗 ?
▁Tom ▁is ▁ind is p ens able .	▁汤姆是 必 不 可 少 的 。
▁Go ▁away !	▁走 开 !
▁Any ▁bed ▁is ▁better ▁than ▁no ▁bed .	▁ 任何 床 都 比 没有 床 好 。
▁I ▁talked ▁to ▁him ▁on ▁the ▁telephone ▁yesterday ▁night .	▁我昨晚 跟他 通 电话 了 。
▁He ▁often ▁qu ot es ▁from ▁S ha k es pe are .	▁他 经常 引 用 莎 士 比 亚 。
▁I ▁study ▁for ▁3 ▁hours ▁every ▁day .	▁我每天 读书 三个 小时 。
▁I ▁wish ▁I ▁could ▁talk ▁to ▁you .	▁我希望 能 与 你 谈话 。
▁Sm oke ▁is ▁ris ing ▁from ▁the ▁ch im ney .	▁ 烟 从 烟 囱 上 升 。
▁I ▁owe ▁it ▁you ▁that ▁I ▁am ▁still ▁alive .	▁多 亏 了 你 , 我 还 活着 。
▁The ▁medicine ▁didn ' t ▁do ▁me ▁any ▁good .	▁这 药 对我 没有任何 好 处 。
▁She ▁cut ▁up ▁the ▁cl oth ▁to ▁make ▁b and ages .	▁她 裁 布 做 绷 带 。
▁G rab ▁a ▁hold ▁of ▁the ▁rope .	▁ 抓住 绳子 。
▁It ▁is ▁imp er ative ▁for ▁you ▁to ▁act ▁at ▁once .	▁你必须 马上 行动 。
▁I ' ll ▁eat ▁here .	▁我会 在这里 吃饭 。
▁You ' d ▁better ▁do ▁as ▁the ▁doctor ▁advised ▁you .	▁你最好 照 着 医生 的 建议 做 。
▁We ▁went ▁all ▁out ▁to ▁get ▁the ▁job ▁done .	▁我们 全 力 以 赴 来 完成 工作 。
▁Who ▁did ▁you ▁talk ▁to ?	▁你 和谁 说话 呢 ?
▁The ▁French ▁lost ▁the ▁bat tle ▁of ▁Water l oo .	▁ 法国 人 在 滑 铁 卢 之 役 吃了 败 仗 。
▁I ▁want ▁some ▁potat oes .	▁我要 几个 土 豆 。
▁Do ▁you ▁mind ▁if ▁I ▁open ▁the ▁door ?	▁你介意 我 开门 吗 ?
▁Tom ▁couldn ' t ▁tell ▁Mary ▁everything ▁he ▁knew .	▁汤姆不能 告诉玛丽 他 知道的 所有 事 。
▁They ' re ▁still ▁in ▁Boston .	▁他们 还 在波士顿 。
▁This ▁v end ing ▁mach ine ▁isn ' t ▁working .	▁这 台 自 动 贩 卖 机 故障 了 。
▁The ▁dog ▁b ark ed ▁at ▁the ▁str anger .	▁这只狗 对 著 陌生 人 叫 。
▁Do ▁you ▁think ▁we ' ll ▁have ▁good ▁weather ?	▁你认为 我们 会 遇到 好 天气 吗 ?
▁He ▁told ▁me ▁an ▁interesting ▁story .	▁他 告诉 了我 一个 有趣的故事 。
▁O ut side ▁the ▁school , ▁she ▁saw ▁people ▁with ▁no ▁h om es ▁living ▁in ▁card bo ard ▁box es .	▁在 校 外 , 她 见到 没有 家 的人 们 住在 纸 板 箱 里 。
▁What ▁is ▁your ▁date ▁of ▁birth ?	▁你的 生日 是 几 号 ?
▁Those ▁two ▁are ▁exactly ▁al ike .	▁那 两个 是一 模 一样 的 。
▁Tom ▁is ▁a ▁fluent ▁speaker ▁of ▁Japanese .	▁汤姆 日语 说得很 流利 。
▁That ▁was ▁an ▁excellent ▁meeting .	▁那是 场 精 彩 的 会议 。
▁She ▁carried ▁that ▁habit ▁to ▁her ▁gr ave .	▁她 到 死 都 改 不了 那个 习惯 。
▁I ▁hope ▁Tom ▁app re ci ates ▁it .	▁我希望汤姆 欣 赏 它 。
▁What ▁have ▁you ▁been ▁doing ▁this ▁week ?	▁你 这个 星期 一直 在做什么 ?
▁I ▁got ▁this ▁vac u um ▁clean er ▁for ▁nothing .	▁我 免费 得到了 这个 吸 尘 器 。
▁Tom ▁doesn ' t ▁even ▁try ▁to ▁help ▁Mary .	▁汤姆 甚至 没 打算 帮 玛丽 。
▁He ▁studies ▁history ▁at ▁college .	▁他在 大学 修 读 历史 。
▁Nothing ▁is ▁really ▁gu ar ant e ed .	▁没有 甚么 是 真正 有 保证 的 。
▁Tom ▁asked ▁us ▁to ▁leave ▁him ▁alone .	▁汤姆要 我们 留 他 独自 一人 。
▁I ▁decided ▁to ▁study ▁abroad .	▁我决定 出国 留 学了 。
▁I ' m ▁new ▁here .	▁我是 新 来的 。
▁He ▁lives ▁next ▁door ▁to ▁us .	▁他住在 我们 隔 壁 。
▁I ▁would ▁like ▁to ▁go ▁to ▁the ▁concert ▁with ▁you .	▁我想 和你 一起去 音乐会 。
▁I ▁spent ▁the ▁whole ▁day ▁in ▁reading ▁the ▁novel .	▁我一 整天 都在 看 这本 小说 。
▁Where ' s ▁the ▁din ing ▁room ?	▁ 餐厅 在哪里 ?
▁This ▁job ▁p ays ▁pretty ▁well .	▁这 工作 报 酬 很高 。
▁My ▁friends ▁don ' t ▁play ▁tennis .	▁我的 朋友 不 打网球 。
▁I ▁wanted ▁to ▁thank ▁you ▁for ▁what ▁you ▁did ▁today .	▁我想 为你 今天 所 做的事 感谢 你 。
▁I ▁can ' t ▁believe ▁anyone ▁anymore .	▁我 再 也不 相信 任何人 了 !
▁I ▁got ▁the ▁money ▁back ▁from ▁him .	▁我 拿 到了 他 还 给我的 钱 。
▁What ▁are ▁you ▁reading ?	▁你在看什么 ?
▁The ▁ce rem ony ▁began ▁with ▁his ▁speech .	▁ 仪 式 以 他的 讲话 开始 。
▁Your ▁prop he cy ▁has ▁come ▁true .	▁你的 预 言 成 真 了 。
▁You ' re ▁the ▁prison er .	▁你是 囚 犯 。
▁There ' s ▁a ▁pub ▁just ▁around ▁the ▁corner .	▁在 转 角 有一 家 酒 吧 。
▁I ▁have ▁been ▁to ▁the ▁bar ber ' s .	▁我 去了 理发 店 。
▁I ▁heard ▁it ▁on ▁the ▁radio .	▁我从 广 播 中 听到 它 。
▁He ▁explain ed ▁his ▁plans ▁in ▁det ail .	▁他 详 细 地 解释 了他的 计划 。
▁I ▁wonder ▁if ▁anything ▁happened ▁to ▁him .	▁我 怀疑 有 什么事 在他 身上 发生了 。
▁My ▁car ▁cost ▁more ▁than ▁yours ▁did .	▁我的 车子 的 开 销 比 你的 要 多 。
▁As ▁soon ▁as ▁she ▁w akes ▁up , ▁we ' ll ▁turn ▁on ▁the ▁music .	▁她一 醒 , 我们就 放 音乐 。
▁What ▁would ▁you ▁like ?	▁你想要 甚么 ?
▁I ▁went ▁to ▁the ▁hospital ▁yesterday .	▁我昨天 去了 医院 。
▁You ▁were ▁supposed ▁to ▁tell ▁Tom ▁that .	▁你该 告诉汤姆 。
▁The ▁baby ▁went ▁to ▁sleep ▁at ▁once .	▁这个 小 婴儿 立刻 去睡觉 了 。
▁I ▁had ▁my ▁brother ▁repair ▁my ▁bicycle .	▁我 让我 哥 修理 我的 自行车 。
▁It ' s ▁time ▁to ▁eat ▁lunch .	▁ 午餐 时间 到了 。
▁He ▁speaks ▁poor ▁French .	▁他 讲 不好 法语 。
▁I ▁will ▁be ▁busy ▁this ▁afternoon .	▁我今天 下午 会 很忙 。
▁M ater n al ▁love ▁is ▁great er ▁than ▁anything ▁else .	▁ 母 爱 比 任何 别 的东西 都 伟 大 。
▁What ' s ▁the ▁meaning ▁of ▁this ▁word ?	▁这个 字 是什么 意思 ?
▁Tom ▁knew ▁that ▁Mary ▁wouldn ' t ▁cry .	▁汤姆 玛丽 不会 哭 。
▁I ▁didn ' t ▁not ice ▁the ▁light ▁turn ▁red .	▁我没有 注意到 灯 变 红 色 了 。
▁I ▁want ▁him ▁to ▁read ▁this .	▁ 想 让他 读 这个 。
▁Tom ▁decided ▁to ▁stay ▁with ▁Mary .	▁汤姆 决定 陪 玛丽 在一起 。
▁I ▁can ' t ▁afford ▁to ▁play ▁tennis .	▁我 负 担 不起 打网球 的 费 用 。
▁They ▁have ▁nothing ▁to ▁eat .	▁他们 没有 东西 吃了 。
▁Tom ▁is ▁not ▁as ▁old ▁as ▁you .	▁汤姆的 年纪 不 比你 大 。
▁What ▁does ▁this ▁pen ▁cost ?	▁这支 笔 多少钱 ?
▁We ▁had ▁a ▁conversation ▁about ▁baseball .	▁我们 交谈 了 有关 棒球 的事 。
▁Their ▁plan ▁sound s ▁interesting ▁to ▁me .	▁他们的 计划 对我来说 很有意思 。
▁I ▁bought ▁a ▁k ite ▁to ▁give ▁to ▁you .	▁我买 了一个 风筝 给你 。
▁I ▁know ▁where ▁I ' m ▁going ▁next .	▁我知道 我 接 下来 去哪里 。
▁We ▁knew ▁it ▁all ▁along .	▁我们 一 开始 就 知道 。
▁The ▁Sw iss ▁cons um e ▁a ▁large ▁amount ▁of ▁beer .	▁ 瑞 士 人 消 耗 不 少 啤酒 。
▁I ' ve ▁got ▁no ▁friends .	▁我没有 朋友 。
▁They ▁moved ▁here ▁three ▁years ▁ago .	▁他们 三年前 搬 到了 这里 。
▁Tom ▁doesn ' t ▁have ▁the ▁time .	▁汤姆没有 时间 。
▁Tom ▁said ▁he ' d ▁wait .	▁汤姆说他 会 等 。
▁Tom ▁is ▁now ▁studying ▁in ▁his ▁room .	▁汤姆现在 在 他的 房间里 学习 。
▁Where ▁did ▁you ▁have ▁your ▁picture ▁taken ?	▁你 从哪里 照 的 相 ?
▁Do ▁you ▁happen ▁to ▁know ▁his ▁name ?	▁你 说不 定 知道 他的名字 ?
▁One ▁more ▁bottle ▁of ▁wine , ▁please .	▁麻烦 再来 一 瓶 葡萄酒 。
▁Is n ' t ▁that ▁good ▁enough ?	▁那 不够 好吗 ?
▁My ▁mother ▁opened ▁the ▁door ▁very ▁carefully .	▁我妈妈 小心 翼 翼 地 打开 门 。
▁The ▁p apers ▁b lew ▁off .	▁ 文件 被 风 刮 起来 。
▁He ▁always ▁takes ▁s ides ▁with ▁her .	▁他总是 支持 她 。
▁She ▁looked ▁after ▁the ▁children .	▁她 照顾 孩子们 。
▁You ▁should ▁know ▁that ' s ▁impossible .	▁你应该 知道 这 是不可能的 。
▁Who ' s ▁the ▁author ▁of ▁this ▁story ?	▁这本 小说 的 作 者 是谁 ?
▁He ▁finally ▁became ▁the ▁president ▁of ▁I B M .	▁他 终于 成了 I B M 的 总 经 理 。
▁You ▁have ▁to ▁give ▁Tom ▁more ▁time .	▁你必须 给汤姆 更多 时间 。
▁I ' ll ▁have ▁to ▁find ▁a ▁part - time ▁job .	▁我得 找 一份 兼 职 工作 。
▁I ▁got ▁up ▁early ▁as ▁us ual .	▁我和 往 常 一样 起 得很 早 。
▁She ▁ra ised ▁her ▁voice .	▁她 提 高 了她的 嗓 音 。
▁I ' ll ▁never ▁forget ▁going ▁to ▁H aw ai i ▁with ▁her .	▁我永远不会 忘记 那 次 跟她 一起去 夏 威 夷 。
▁I ▁want ▁to ▁go ▁with ▁a ▁friend ▁to ▁Hokkaido ▁next ▁month .	▁我想 下个月 和 一个朋友 去 北海道 。
▁F ish ▁and ▁red ▁wine ▁don ' t ▁go ▁well ▁together .	▁ 鱼 和 红 酒 不 合 。
▁There ▁are ▁many ▁beautiful ▁c ast les ▁in ▁n ort her n ▁Germany .	▁在 德国 北 部 有很多 美丽的 城 堡 ?
▁How ' s ▁school ?	▁学校 怎么样 ?
▁I ▁love ▁my ▁work ▁very ▁much .	▁我非常 喜欢 我的 工作 。
▁I ' m ▁afraid ▁of ▁death .	▁我怕 死 。
▁I ' ll ▁be ▁able ▁to ▁assist ▁you .	▁我能 协 助 你 。
▁They ▁all ▁have ▁come .	▁他们 全都 来了 。
▁Whose ▁idea ▁was ▁it ▁to ▁call ▁the ▁police ?	▁ 想 报 警 的 是谁 ?
▁It ' s ▁my ▁job .	▁这是我 份 内 的事 。
▁Tom ▁heard ▁this ▁and ▁got ▁angry .	▁ 听到 这事 之后 , 汤姆 为 之 色 变 。
▁I ' m ▁old ▁enough ▁to ▁support ▁myself .	▁我 年纪 够 大 可以 养 活 我 自己 。
▁Do ▁you ▁want ▁to ▁die ▁here ?	▁你想 死 在这里 吗 ?
▁That ' s ▁not ▁a ▁cat . ▁It ' s ▁a ▁dog .	▁那 不是 猫 。 那是 狗 。
▁I ' m ▁coming ▁to ▁see ▁you ▁tomorrow .	▁我明天 会来 看 你 。
▁Your ▁friends hip ▁means ▁a ▁lot ▁to ▁me .	▁你的 友 谊 对我来说 意义 重 大 。
▁I ▁like ▁to ▁walk ▁in ▁the ▁country .	▁我喜欢 在 乡 间 散步 。
▁After ▁she ▁had ▁read ▁the ▁letter , ▁she ▁to re ▁it ▁to ▁pie ces .	▁ 看了 信 之后 , 她 把它 撕 成 碎 片 。
▁I ▁love ▁music .	▁我爱 音乐 。
▁The ▁accident ▁took ▁place ▁at ▁that ▁corner .	▁事故 发生在 转 角 。
▁P ric es ▁have ▁dropped ▁recently .	▁ 最近 物 价 已经 下 降 。
▁May ▁I ▁ask ▁how ▁old ▁you ▁are ?	▁请问 您 老人 家 高 寿 ?
▁You ▁should ▁eat ▁more ▁vegetables .	▁你应该 多 吃 蔬菜 。
▁He ▁ear ns ▁his ▁living ▁by ▁writing .	▁他 靠 写 作 谋 生 。
▁Don ' t ▁change ▁your ▁mind .	▁不要 改变 你的 心 意 。
▁Mother ▁b akes ▁cookies ▁on ▁Sundays .	▁妈妈 周日 烤 曲 奇 。
▁Our ▁teacher ▁made ▁us ▁clean ▁the ▁room .	▁我们 老师 要 我们 打扫 这 间 房间 。
▁I ▁need ▁my ▁coat .	▁我需要 我的 大衣 。
▁He ▁lives ▁alone .	▁他 独自 生活 。
▁They ▁didn ' t ▁keep ▁their ▁promise .	▁他们 没有 信守 诺言 。
▁Don ' t ▁speak ▁un less ▁you ▁have ▁something ▁worth ▁saying .	▁除 非 你 有什么 值得 说的话 要 说 , 否 则 就 别 吭 声 。
▁Are ▁you ▁a ▁student ▁of ▁a ▁private ▁high ▁school ?	▁你在 私 立 高中 读书 吗 ?
▁He ▁studied ▁hard .	▁他 努力学习 。
▁He ▁arrived ▁after ▁I ▁had ▁left .	▁我 走 之后 他 到达 了 。
▁The ▁room ▁smell ed ▁of ▁to b ac c o .	▁ 房 里 闻 起来 有 股 烟 味 。
▁You ▁should ▁have ▁come ▁earlier .	▁你本 应该 来 得 更 早 的 。
▁I ▁think ▁she ' s ▁an ▁honest ▁woman .	▁我认为 她 是一个 诚实 的女人 。
▁I ▁accepted ▁her ▁inv itation .	▁我 接受 了她的 邀请 。
▁Tom ▁should ▁have ▁hand led ▁the ▁situation ▁different ly .	▁汤姆应该 用 别 的方式 处理 这 状 况 。
▁I ▁am ▁fam iliar ▁with ▁this ▁subject .	▁我 熟悉 这个 主 题 。
▁She ▁was ▁in ▁America ▁last ▁month .	▁她 上 个月 在 美国 。
▁I ' m ▁not ▁feeling ▁well .	▁我感觉 不舒服 。
▁Go ▁get ▁your ▁he l m et .	▁ 戴 上你的 安全 帽 。
▁I ' ve ▁always ▁dist r ust ed ▁Tom .	▁我一直 不 信任 汤姆 。
▁You ▁have ▁a ▁way ▁with ▁women .	▁你对 女人 有一 套 。
▁Tom ' s ▁good , ▁but ▁not ▁good ▁enough .	▁汤姆 好 , 但 不够 好 。
▁The ▁boat ▁is ▁going ▁against ▁the ▁cur ren t .	▁船 逆 流 航 行 。
▁I ▁have ▁recently ▁given ▁up ▁smoking .	▁我 最近 戒烟 了 。
▁I ▁can ' t ▁make ▁any ▁sense ▁of ▁this .	▁我完全 不 明白 。
▁I ▁think ▁I ▁understand .	▁我想 我 懂 了 。
▁You ▁need ▁to ▁pay ▁ext ra ▁for ▁the ▁bat ter ies .	▁ 电 池 要 额 外 付钱 。
▁Do ▁you ▁have ▁anything ▁to ▁say ?	▁你有 任何 话 要 说吗 ?
▁I ▁found ▁your ▁letter ▁in ▁the ▁mail bo x .	▁我在 信 箱 中 发现了 你的信 件 。
▁She ▁always ▁gets ▁her ▁own ▁way .	▁她总是 随 心 所 欲 。
▁I ▁like ▁you .	▁我喜欢 你 。
▁Tom ▁st ood ▁up ▁from ▁his ▁chair .	▁汤姆从 椅子 上 站 了 起来 。
▁Get ▁serious .	▁ 认 真 点 。
▁How ▁much ▁will ▁it ▁cost ▁you ▁to ▁go ▁by ▁air ?	▁ 坐 飞机 将 花 你 多少钱 ?
▁Will ▁you ▁show ▁me ▁your ▁ph oto ▁al bum ?	▁你能 让我 看看 你的 相 簿 吗 ?
▁They ' re ▁requ ired ▁to ▁work ▁eight ▁hours ▁every ▁day .	▁他们 每天 必须 工作 8 小时 。
▁You ▁can ' t ▁speak ▁English , ▁can ▁you ?	▁你 不会 说英语 , 是吗 ?
▁He ▁has ▁a ▁test ▁next ▁week .	▁他 下 礼拜 要 考试 。
▁L ake ▁B ai k al ▁in ▁R uss ia ▁is ▁the ▁deep est ▁lake ▁in ▁the ▁world .	▁ 俄 罗 斯 的 贝 加 尔 湖 是 世界上 最 深 的 湖 泊 。
▁W in ter ▁is ▁over ▁and ▁spring ▁has ▁come .	▁ 冬天 结束了 春天 已经 来了 。
▁I ▁have ▁to ▁take ▁a ▁test ▁tomorrow .	▁明天 我 必须 参加 考试 。
▁Tom ▁knows ▁it ' s ▁over .	▁汤姆知道 它 结束了 。
▁No ▁one ▁lived ▁on ▁the ▁is land ▁at ▁that ▁time .	▁那个 时候 , 没有人 在这个 岛 上 生活 。
▁Can ' t ▁you ▁low er ▁your ▁voice ?	▁你不能 小 声 点 说话 吗 ?
▁Don ' t ▁put ▁your ▁el b ow s ▁on ▁the ▁table .	▁不要 把你的 手 肘 放在 桌子上 。
▁You ' ve ▁got ▁a ▁great ▁memory .	▁你的 记忆 力 很好 。
▁The ▁couple ▁had ▁a ▁son .	▁这 对 夫 妇 生 了个 儿子 。
▁The ▁to il et ▁is ▁back ed ▁up .	▁ 厕 所 塞 住了 。
▁He ▁give s ▁some ▁meat ▁to ▁the ▁dog .	▁他 给 这 只狗 一些 肉 。
▁What ▁are ▁you ▁doing ▁tonight ?	▁你 今晚 在做什么 ?
▁I ' ve ▁got ▁one ▁for ▁you .	▁我 给你 带 了一个 。
▁Water ▁bo il s ▁at ▁one ▁hundred ▁deg rees .	▁水 在 摄 氏 100 度 沸 腾 。
▁He ▁has ▁a ▁good ▁comm and ▁of ▁English .	▁他有 很好的 英语 能力 。
▁Your ▁English ▁has ▁impro ved ▁a ▁lot .	▁你的 英语 进步 了很多 。
▁She ▁asked ▁a ▁very ▁good ▁question .	▁她问 了一个 非常 好的 问题 。
▁I ▁think ▁that ' s ▁aw ful .	▁我看 那 糟 透 了 。
▁It ▁was ▁ext rem ely ▁sc ary .	▁这 太 可怕 了 。
▁May ▁I ▁borrow ▁your ▁car ?	▁我可以 借 用 你的 车吗 ?
▁There ▁was ▁sc ar ce ly ▁any ▁money ▁left .	▁几乎 没 剩 下 钱 。
▁Tom ▁f re qu ently ▁talks ▁in ▁his ▁sleep .	▁汤姆 经常 说 梦 话 。
▁The ▁shop ▁is ▁open ▁from ▁Monday ▁to ▁Saturday .	▁这家 店 从 星期一 到 星期 六 都 营 业 。
▁Tom ▁has ▁app a ren t ly ▁done ▁that ▁already .	▁很 明显 , 汤姆 已经 做 完了 。
▁I ▁love ▁n ature .	▁我爱 大 自然 。
▁He ▁asked ▁me ▁if ▁I ▁was ▁busy .	▁他 问我 是否 很忙 ?
▁I ▁object ed ▁to ▁his ▁pay ing ▁the ▁bill .	▁我 反对 他 付 帐 单 。
▁Tom ▁talked ▁about ▁his ▁school .	▁汤姆 谈 了他的 学校 。
▁D est ro y ▁this ▁temp le .	▁ 摧 毁 这个 寺 庙 。
▁This ▁book ▁is ▁beautif ully ▁ill ust r ated .	▁这本书 有 精 美 的 插 图 。
▁He ▁won ' t ▁live ▁a ▁long ▁life .	▁他不会 长 寿 。
▁We ▁have ▁to ▁turn ▁in ▁our ▁report s ▁by ▁the ▁end ▁of ▁this ▁month .	▁这个 月 底 前 , 我们 必须 交 报告 。
▁Who ' s ▁worried ▁about ▁Tom ?	▁谁 担心 汤姆 ?
▁Both ▁of ▁her ▁son s ▁died ▁during ▁the ▁war .	▁她的 孩子 都 死于 战 乱 。
▁Do ▁you ▁know ▁this ▁song ?	▁你知道 这 首歌 吗 ?
▁Come ▁to ▁my ▁house ▁this ▁afternoon .	▁今天下午 到我 家 来 一 趟 。
▁The ▁to il et ▁doesn ' t ▁fl ush ▁prop er ly .	▁ 厕 所 冲 水 不 正常 。
▁I ▁am ▁here ▁on ▁business .	▁我 在这里 出 差 。
▁" Tom ▁isn ' t ▁here ." ▁" T hen ▁where ▁is ▁he ?"	▁“ 汤姆 不在 那儿 。”“ 那么 他在 哪儿 ?”
▁Many ▁mo ons ▁or bit ▁around ▁S at urn .	▁许多 卫 星 绕 著 土 星 运 行 。
▁There ' s ▁no ▁need ▁to ▁speak ▁so ▁loud .	▁没有 必要 说话 这么 大声 。
▁Tom ▁stopped ▁me ▁from ▁enter ing ▁the ▁bank .	▁汤姆 阻止 我 进 银行 。
▁It ▁seems ▁so ▁fam iliar .	▁这 看起来 似 曾 相 识 。
▁Tom ▁still ▁doesn ' t ▁know ▁the ▁truth .	▁汤姆 还是 不知道 真相 。
▁" I s ▁he ▁right ?" ▁" I ▁don ' t ▁think ▁so ."	▁" 他是 对 的吗 ?" ▁" 我不 这么 认为 。"
▁That ▁river ▁is ▁dangerous .	▁那 条 河 是 危险的 。
▁V al u able ▁time ▁has ▁been ▁lost .	▁ 宝 贵 的时间 已 失去 。
▁We ▁watched ▁a ▁baseball ▁game ▁on ▁television .	▁我们 看了 电视 上的 棒球 比赛 。
▁That ' s ▁because ▁you ' re ▁a ▁girl .	▁那是 因为 妳 是 女 生 。
▁Will ▁you ▁please ▁turn ▁down ▁the ▁radio ?	▁请你把 收音机 关 小 声 一点 好吗 ?
▁I ' m ▁actually ▁doing ▁quite ▁well .	▁我 其 实 做 得很好 。
▁Is ▁it ▁yours ?	▁这是你的 吗 ?
▁He ▁press ured ▁me .	▁他 向我 施 压 。
▁You ▁re ap ▁what ▁you ▁s ow .	▁ 种 瓜 得 瓜 , 种 豆 得 豆 。
▁We ▁can ' t ▁tell ▁which ▁is ▁better .	▁我们 无法 辨 别 哪个 更好 。
▁Her ▁hair ▁is ▁st reak ed ▁with ▁gr ay .	▁她的 头发 中 夹 有 白 发 。
▁The ▁R h ine ▁runs ▁between ▁France ▁and ▁Germany .	▁ 莱 茵 河 流 经 法国 和 德国 国 界 。
▁It ▁makes ▁no ▁sense ▁what so ever .	▁无论 如何 说不 通 。
▁We ' re ▁friends ▁from ▁way ▁back .	▁我们是 老 朋友 了 。
▁He ' s ▁high ly ▁int ell ig ent .	▁他 聪明 得很 。
▁It ▁is ▁never ▁too ▁late ▁to ▁learn .	▁ 活 到 老 , 学 到 老 。
▁Maybe ▁I ' m ▁just ▁a ▁fool .	▁可能 我就 是个 傻 子 。
▁He ▁can ▁play ▁tennis ▁very ▁well .	▁他 网球 打 得很好 。
▁The ▁girl ▁made ▁an ▁aw k ward ▁b ow .	▁这个 女孩 做了一 把 不 称 手 的 弓 。
▁What ' s ▁your ▁job ▁here ?	▁你 在这里 的工作 是什么 ?
▁L ou der , ▁please .	▁请 大声 一点 。
▁I ' ll ▁be ▁back ▁in ▁a ▁j if f y .	▁我 马上 就 回来 。
▁Tom ▁wanted ▁re ven ge .	▁汤姆想 报 仇 。
▁It ▁is ▁no ▁use ▁asking ▁him ▁again .	▁再 问他 也没 用 。
▁My ▁father ▁does ▁not ▁eat ▁much ▁fruit .	▁我父亲 没有 吃 很多 的 水果 。
▁We ▁have ▁to ▁sing ▁at ▁an ▁old ▁f ol k s ▁home ▁today .	▁我们 今天 得 去 养 老 院 唱歌 。
▁I ▁can ' t ▁stand ▁this ▁noise ▁any ▁longer .	▁我无法 再 忍受 这个 噪音 了 。
▁My ▁mother ▁never ▁pun is hes ▁me .	▁我母亲 从来 没有 惩罚 过 我 。
▁Do ▁you ▁want ▁to ▁be ▁an ▁a ctor ▁in ▁a ▁movie ?	▁你想 成为一名 电影 演员 吗 ?
▁Let ' s ▁get ▁off ▁here .	▁我们 在这里 下车 吧 。
▁The ▁kid n app ers ▁showed ▁no ▁sign ▁of ▁giving ▁up .	▁这些 绑 匪 没有 放弃 的 迹 象 。
▁This ▁train ▁leaves ▁at ▁nine ▁o ' clock .	▁这 班火车 九 点钟 发 车 。
▁Why ▁do ▁you ▁ask ?	▁你 问 这个 干什么 ?
▁She ▁looks ▁pretty ▁in ▁that ▁dress .	▁她穿 上 那 件 衣服 看起来很 漂亮 。
▁The ▁weather ▁is ▁usually ▁hot ▁in ▁J u ly .	▁ 七 月 天气 经常 很 热 。
▁He ▁st ress ed ▁the ▁con ven ient ▁as pect s ▁of ▁city ▁life .	▁他 强 调 都 市 生活 的 便 利 方 面 。
▁He ▁likes ▁to ▁travel ▁by ▁himself .	▁他喜欢 独自 旅行 。
▁When ▁was ▁this ▁university ▁found ed ?	▁这 所 大学 是 什么时候 建 的 ?
▁Do ▁you ▁like ▁shopping ?	▁你喜欢 购物 吗 ?
▁He ▁is ▁an ▁Ital ian .	▁他是 义 大利 人 。
▁B ut ▁you ' re ▁not ▁there .	▁但 你不 在那里 。
▁I ▁finished ▁reading ▁the ▁book ▁last ▁night .	▁我昨晚 看 完了 这本书 。
▁I ' m ▁really ▁sorry . ▁I ▁seem ▁to ▁have ▁lost ▁your ▁umbrella .	▁我 真的很 抱歉 , 我 好像 弄 丢了 你的 雨 伞 。
▁Do ▁you ▁trust ▁her ?	▁你相信 她 吗 ?
▁I ▁should ▁obey .	▁我应该 服 从 。
▁I ▁can ' t ▁find ▁fault ▁with ▁him .	▁我 挑 不 出 他的 毛 病 。
▁How ▁did ▁your ▁j our ney ▁begin ?	▁你的 旅行 是 怎么 开始 的 ?
▁Those ▁h ous es ▁are ▁5 00 ▁years ▁old .	▁那些 房子 有 5 00 年了 。
▁If ▁we ▁don ' t ▁keep ▁walking ▁we ' ll ▁be ▁late .	▁如果 我们 不 继续 赶 路 , 我们 会 迟到 的 。
▁He ▁t end s ▁to ▁be ▁late ▁for ▁meeting s .	▁他 开 会 往 往 会 迟到 。
▁He ▁le an ed ▁on ▁his ▁el b ow s .	▁他把 身 子 靠 在 胳 膊 上 。
▁You ' re ▁really ▁beautiful .	▁你 真的很 漂亮 。
▁B ir ds ▁fly .	▁鸟 类 飞 行 。
▁School ▁start s ▁next ▁Monday .	▁ 下周 一 开 学 。
▁Let ▁me ▁take ▁your ▁blood ▁pressure .	▁让我 量 量 你的 血 压 。
▁A ▁w ise ▁man ▁prof it s ▁from ▁his ▁mistakes .	▁ 聪明 人 会 从 自己的 错误 中 受 益 。
▁I ▁don ' t ▁remember ▁any ▁of ▁it .	▁我对 这些 都没有 印象 。
▁He ▁studied ▁abroad .	▁他 出国 留 学了 。
▁Stay ▁and ▁have ▁a ▁drink ▁with ▁us .	▁ 留 下来 和 我们 一起 喝酒 吧 。
▁Tom ▁had ▁to ▁sell ▁his ▁house .	▁汤姆 必须 卖 了他的 房子 。
▁I ▁can ' t ▁explain ▁it ▁now .	▁我现在 不能 解释 。
▁Will ▁six ▁o ' clock ▁suit ▁you ?	▁ 六点钟 你 方便 吗 ?
▁L ove ▁is ▁like ▁o x y g en .	▁爱 就像 氧 气 。
▁The ▁taller ▁the ▁tree , ▁the ▁more ▁likely ▁it ▁is ▁to ▁be ▁str uck ▁by ▁light ning .	▁ 树 高 遭 雷 击 。
▁Don ' t ▁be ▁afraid ▁to ▁make ▁mistakes ▁when ▁you ▁speak ▁English .	▁当你 说英语 的时候不要 怕 犯错 。
▁Are ▁you ▁free ▁tomorrow ?	▁你明天 有空 吗 ?
▁Why ▁not ?	▁为什么 不 ?
▁He ▁passed ▁the ▁ent r ance ▁exam ination .	▁他 通 过了 入 学 考试 。
▁You ' ve ▁been ▁had .	▁您 被 骗 了 。
▁It ▁rain ed ▁on ▁and ▁off ▁all ▁day .	▁雨 断 断 续 续 地 下了一 整天 。
▁We ▁are ▁having ▁a ▁serious ▁talk ▁about ▁your ▁future .	▁我们在 严 肃 地 谈论 你的 未 来 。
▁You ▁are ▁tired , ▁aren ' t ▁you ?	▁你 累了 , 不是吗 ?
▁Don ' t ▁talk ▁to ▁others ▁during ▁the ▁class .	▁上 课 中 不要 跟 别人 讲话 。
▁I ' m ▁going ▁to ▁the ▁bank .	▁我要 去 银行 了 。
▁He ▁is ▁older ▁than ▁she ▁is ▁by ▁three ▁years .	▁他比 她 大 三岁 。
▁Would ▁you ▁close ▁the ▁window ?	▁请您 把 窗户 关 起来 好吗 ?
▁That ▁white ▁dress ▁looks ▁good ▁on ▁you .	▁你 穿 那 件 白 色的 衣服 很好 看 。
▁Could ▁you ▁put ▁this ▁report ▁into ▁Ital ian ▁for ▁me ?	▁你可以 为我 把 这 份 报告 翻译 成 意大利 文 吗 ?
▁I ▁can ' t ▁be ar ▁to ▁deal ▁with ▁her ▁anymore .	▁我 再也 忍受 不了 她 了 !
▁My ▁dream ▁is ▁to ▁be ▁a ▁doctor .	▁我的 梦想 是 成为 医生 。
▁They ▁were ▁not ▁listening ▁to ▁music .	▁他们 没 在 听音乐 。
▁I ▁am ▁busy ▁today .	▁我今天 忙 。
▁The ▁situation ▁is ▁impro ving , ▁so ▁che er ▁up !	▁ 情况 正在 改 善 , 所以 振 作 起来 !
▁The ▁baby ▁is ▁playing ▁with ▁some ▁to ys .	▁这个 小 婴儿 正在 玩 一些 玩具 。
▁S ha ke ▁my ▁hand .	▁ 和我 握 手 。
▁It ▁isn ' t ▁pol ite ▁to ▁st are ▁at ▁people .	▁ 盯 著 人 看 是不 礼貌 的 。
▁I ▁will ▁come ▁earlier ▁next ▁time .	▁我 下 次 会 早点 来 。
▁I ' m ▁sorry ▁to ▁hear ▁it .	▁我听 了 感到 抱歉 。
▁When ▁we ' re ▁children , ▁everything ▁around ▁us ▁looks ▁so ▁big .	▁我们 小 时候 , 所有的 一切 对我们 来说 都 显 得 那么 大 。 。 。
▁My ▁mom ▁gets ▁out ▁of ▁bed ▁before ▁me .	▁我妈妈 比我 早起 。
▁I ▁saw ▁the ▁sun r ise .	▁我 看了 日 出 。
▁Tom ▁wrote ▁Mary ▁a ▁long ▁letter , ▁but ▁he ▁didn ' t ▁send ▁it ▁to ▁her .	▁汤姆 给玛丽 写了 封 长 信 , 可 是 没有 寄 给她 。
▁I ▁just ▁talked ▁to ▁the ▁person ▁in ▁charge .	▁我刚 跟 主 管 人 谈 过 。
▁I ▁know ▁that ▁you ▁did ▁your ▁best .	▁我知道你 尽力 了 。
▁R ice ▁is ▁grow n ▁in ▁rain y ▁reg ions .	▁人们 在 多 雨 地 区 种 植 水 稻 。
▁My ▁father ▁was ▁no ▁less ▁affect ion ate ▁and ▁t end er ▁to ▁me ▁than ▁my ▁mother ▁was .	▁我爸爸 对 我的 爱 和 照顾 不 比我 妈妈 少 。
▁My ▁mother ▁plays ▁the ▁piano ▁well .	▁我的 母亲 钢琴 弹 得很好 。
▁I ' m ▁dis app oin ted ▁that ▁I ▁wasn ' t ▁able ▁to ▁go ▁with ▁her .	▁我很 失望 我没 能 和她 一起去 。
▁Do ▁you ▁know ▁which ▁de ity ▁this ▁temp le ▁is ▁d edic ated ▁to ?	▁您 知道 这 座 庙 宇 供 奉 的是 哪个 神 吗 ?
▁O h ▁please !	▁ 噢 拜 托 了 !
▁The ▁days ▁are ▁getting ▁longer ▁and ▁longer .	▁ 白 天 渐 渐 地 越来越 长 。
▁Nobody ▁can ▁know ▁everything .	▁没有人 能 无所 不 知 。
▁Do ▁you ▁ever ▁study ▁in ▁the ▁library ?	▁你 曾经 在 图书馆 读书 吗 ?
▁I ▁really ▁enjoyed ▁myself ▁tonight .	▁今晚 我 玩得很开心 。
▁This ▁is ▁a ▁picture ▁of ▁my ▁mother .	▁这张 是我 妈妈 的照片 。
▁T ime ▁wait s ▁for ▁no ▁one .	▁ 时间 不 等 人 。
▁I ' m ▁dead ▁tired .	▁我 累 死了 。
▁I ' ve ▁no ▁idea .	▁我一 无所知 。
▁Tom ▁is ▁the ▁tall est ▁in ▁his ▁class .	▁汤姆是 班 上 最 高的 。
▁The ▁red ▁dress ▁looked ▁good ▁on ▁her .	▁她穿 这 套 红色的 洋装 很好 看 。
▁I ▁heard ▁someone ▁in ▁the ▁crowd ▁outside ▁the ▁station ▁call ▁my ▁name .	▁我听到 车站 外 的人 群 中 有人 在 叫 我的 名字 。
▁I ' ll ▁go ▁to ▁the ▁library ▁with ▁you ▁tomorrow .	▁我明天 要 跟你 去 图书馆 。
▁How ▁much ▁of ▁what ▁I ' ve ▁written ▁here ▁do ▁you ▁understand ?	▁你 了解 多少 我 写 在这里 的东西 ?
▁I ▁got ▁acqu ainted ▁with ▁him ▁last ▁night .	▁我昨晚 认识 了他 。
▁Even ▁th ough ▁she ▁grew ▁up ▁in ▁Japan , ▁she ▁speaks ▁fluent ▁English .	▁尽管 她在 日本 长大 , 她 说 一 口 流利 的英语 。
▁This ▁book ▁will ▁do .	▁这本书 就 行 了 。
▁This ▁makes ▁me ▁angry .	▁这 让我 愤 怒 。
▁Please ▁call ▁the ▁police .	▁ 叫 警察 。
▁I ▁don ' t ▁know ▁if ▁I ▁have ▁time ▁to ▁do ▁it .	▁我不知道 我 是否 有 时间 做 。
▁Don ' t ▁forget ▁me .	▁别 忘 了我 。
▁C ertain ly ▁she ▁is ▁correct .	▁当 然 , 她 是 正确的 。
▁What ▁does ▁this ▁key ▁unl ock ?	▁这 钥匙 能 打开 什么 ?
▁That ▁inc ident ▁made ▁him ▁famous .	▁这 起 事 件 使 他 一 举 成 名 。
▁I ▁introdu ced ▁Mary ▁to ▁my ▁parents .	▁我把 玛丽 介绍 给我的 父母 了 。
▁My ▁driving ▁in str u ctor ▁says ▁I ▁should ▁be ▁more ▁patient .	▁我的 驾驶 教 练 说 我 应该 更 有 耐心 一点 。
▁I ▁have ▁an ▁umbrella ▁in ▁my ▁car .	▁我的 车 里有 伞 。
▁He ' s ▁a ▁big ▁boy .	▁他是个 大 男孩 。
▁Turn ▁on ▁the ▁radio , ▁please .	▁请 打开 收音机 。
▁I ' m ▁used ▁to ▁it ▁by ▁now .	▁我现在 已经 习惯 它了 。
▁I ' ve ▁read ▁many ▁kind s ▁of ▁books .	▁我已经 读过 很多 种 类 的书 了 。
▁He ▁is ▁always ▁laugh ing .	▁他总是 在 笑 。
▁We ▁work ▁in ▁a ▁factory .	▁我们在 一个 工厂 工作 。
▁Life ▁is ▁full ▁of ▁up s ▁and ▁down s .	▁人 生 充 满了 高 低 起 伏 。
▁There ' s ▁no ▁need ▁to ▁hurry .	▁没有 必要 著 急 。
▁I ▁was ▁a ▁high ▁school ▁student ▁at ▁that ▁time .	▁我 当时 是 高中 生 。
▁The ▁ent ire ▁world ▁des ire s ▁peace .	▁ 整个 世界 都 需要 和平 。
▁Please ▁give ▁me ▁a ▁cup ▁of ▁water .	▁请你 给我 一杯水 。
▁Leave ▁a ▁sp ace ▁between ▁the ▁l ines .	▁ 行 与 行 之间 要 留 一个 空 间 。
▁The ▁cat ▁is ▁sleeping ▁on ▁the ▁so f a .	▁猫 正在 沙发 上 睡觉 。
▁I ▁seem ▁to ▁be ▁unl uck y ▁today .	▁我今天 看来 很 幸运 。
▁They ▁only ▁sell ▁women ' s ▁shoes ▁here .	▁这里 只 卖 女 鞋 。
▁I ▁know ▁you ▁think ▁I ' m ▁crazy .	▁我知道你 觉得 我 疯了 。
▁Only ▁one ▁little ▁boy ▁sur vi ved ▁the ▁traffic ▁accident .	▁这 次 交通 事故 中 只 有一个 小 男孩 幸 存 了下来 。
▁She ▁is ▁what ▁we ▁call ▁a ▁book w orm .	▁她 就是 所 谓 的书 虫 。
▁I ' m ▁glad ▁to ▁see ▁you ▁back .	▁很 高兴 再 见到你 。
▁I ▁made ▁him ▁paint ▁the ▁house .	▁我 让他 刷 房子 。
▁Get ▁down ▁on ▁the ▁floor !	▁ 趴 在地 上 !
▁Were ▁you ▁out ▁last ▁night ?	▁昨晚 你 出去 了吗 ?
▁M om , ▁can ▁I ▁go ▁swimming ?	▁妈妈 , 我能 去 游泳吗 ?
▁I ▁don ' t ▁mind ▁if ▁it ' s ▁hot ▁and ▁sp ic y .	▁ 辣 点儿 没关系 。
▁Tom ▁p ushed ▁his ▁way ▁through ▁the ▁crowd .	▁汤姆从 人 群 中 拥 出来 。
▁We ' ve ▁got ▁to ▁get ▁you ▁some ▁help .	▁我们不 得不 给你 一点 帮助 了
▁Have ▁you ▁ever ▁seen ▁Tokyo ▁T ower ?	▁你 曾 看过 东京 铁 塔 吗 ?
▁I ' ve ▁never ▁met ▁him .	▁我从来 没有 见过 他 。
▁When ▁was ▁this ▁temp le ▁built ?	▁这个 寺 庙 是 何时 造 的 ?
▁F e lic j a ▁likes ▁to ▁watch ▁TV .	▁F e lic j a 喜欢 看电视 。
▁One ▁good ▁friend ▁is ▁better ▁than ▁ten ▁rel ative s .	▁一个 好 友 胜过 十 个 亲 戚 。
▁Tom ▁goes ▁for ▁a ▁walk ▁every ▁morning .	▁Tom 每天早上 去 散步 。
▁Your ▁cake ▁is ▁delicious .	▁您的 蛋糕 很美 味 。
▁Why ▁don ' t ▁you ▁have ▁a ▁party ?	▁你为什么不 举行 派对 ?
▁Can ▁we ▁save ▁the ▁planet ?	▁我们能 拯 救 这 颗 星 球 吗 ?
▁Would ▁you ▁lend ▁me ▁some ▁money ?	▁你可以 借我 一些 钱 吗 ?
▁I ▁haven ' t ▁yet ▁finished ▁my ▁supper .	▁我还没 吃完 晚饭 。
▁These ▁flowers ▁can ▁be ▁seen ▁around ▁Hokkaido .	▁在 北海道 周围 可以 看到 这些 花 。
▁That ▁was ▁a ▁month ▁ago .	▁那 是一个 月 前 了 。
▁I ▁agree ▁with ▁Tom ▁a ▁hundred ▁per cent .	▁我 百 分之 百 同意 Tom 。
▁What ▁is ▁this ?	▁这是什么 ?
▁The ▁boys ▁kept ▁quiet .	▁ 男 孩子们 保持安静 。
▁You ▁can ' t ▁build ▁building s ▁on ▁sw am p y ▁land .	▁你不能 在 沼 泽 地上 建 造 建筑 物 。
▁I ▁support ▁pol it ical ▁ref orm .	▁我 支持 政治 改 革 。
▁I ' m ▁glad ▁to ▁see ▁you ▁again .	▁很 高兴 再次 见到你 。
▁R ather ▁than ▁cut ting ▁down ▁on ▁c ig are t t es , ▁why ▁don ' t ▁you ▁just ▁give ▁them ▁up ?	▁ 比 起 少 抽烟 , 你 何 不 直 接 把 烟 戒 了 ?
▁At ▁last , ▁it ▁began ▁to ▁rain .	▁ 终于 开始 下雨了 。
▁You ▁can ▁trust ▁him ▁to ▁keep ▁his ▁word .	▁你可以 相信 他会 信守 诺言 。
▁I ▁wonder ▁what ▁else ▁Tom ▁wants .	▁我想知道 汤姆 还 要 别 的 什么 。
▁I ▁can ' t ▁fig ure ▁him ▁out .	▁我不 了解 他 。
▁Put ▁it ▁back ▁on ▁the ▁desk .	▁把 它 放 回 桌子上 。
▁She ▁cook ed ▁veget able ▁soup ▁for ▁us .	▁她为 我们 煮 了 蔬菜 汤 。
▁I ▁have ▁no ▁idea ▁what ▁I ' m ▁going ▁to ▁wear .	▁我不知道 穿 甚么 好 。
▁The ▁bus ▁was ▁filled ▁to ▁cap ac ity .	▁这辆 公车 客 满了 。
▁I ▁turned ▁the ▁door k n ob .	▁我 转 动了 门 把 。
▁She ▁makes ▁all ▁her ▁own ▁clothes .	▁她的 衣服 全部 都是 她 自己 做的 。
▁He ▁doesn ' t ▁know ▁any ▁of ▁us .	▁他不 认识 我们 中的 任何 一个 。
▁There ' s ▁nothing ▁more ▁pain ful ▁than ▁lo sing ▁one ' s ▁child .	▁没有 比 失去 孩子 更 让 人 悲伤 的事 。
▁How ▁do ▁you ▁like ▁your ▁eggs ▁done ?	▁你的 蛋 要 怎么做 ?
▁Don ' t ▁throw ▁away ▁this ▁magazine . ▁I ▁haven ' t ▁read ▁it ▁yet .	▁这本 杂志 不要 扔 。 我 还没 看 呢 。
▁I ▁think ▁we ▁shouldn ' t ▁allow ▁Tom ▁to ▁do ▁that .	▁我认为我们 不 应该 允许 汤姆 去做 。
▁Tom ▁will ▁come ▁back ▁from ▁Boston ▁next ▁Monday .	▁汤姆 会在 下周 一 从 波士顿 回来 。
▁I ' ve ▁done ▁everything ▁necessary .	▁我做 完了 所有 重要 的事 。
▁It ' s ▁my ▁brother ' s .	▁它 是我 兄弟 的 。
▁The ▁problem ▁is ▁being ▁discuss ed ▁now .	▁这 问题 正在 被 讨论 。
▁They ▁ob t ained ▁a ▁y ie ld ▁of ▁8 ▁per cent ▁on ▁their ▁invest ment .	▁他们 在这 次 的 投 资 中 得到 百 分之 八 的 收 益 。
▁I ▁don ' t ▁know ▁much ▁about ▁computer s .	▁我对 电脑 知道的 不多 。
▁I ' m ▁looking ▁forward ▁to ▁seeing ▁you ▁next ▁Sunday .	▁我期待 下周日 能 见到你 。
▁I ▁usually ▁have ▁breakfast ▁at ▁seven .	▁我通常 七点 吃早餐 。
▁She ▁knows ▁a ▁lot ▁about ▁the ▁l at est ▁fash ions .	▁她很 了解 最 新的 时 尚 趋 势 。
▁What ▁on ▁earth ▁are ▁you ▁talking ▁about ?	▁你 到底 在 谈 什么 ?
▁Tom ▁made ▁a ▁choice .	▁汤姆 做 出了 选择 。
▁When ▁D ad ▁find s ▁out ▁what ▁you ' ve ▁done , ▁he ' s ▁going ▁to ▁hit ▁the ▁r oof .	▁当 爸爸 发现 你 做了什么 的时候 , 他会 发 疯 的 。
▁Let ' s ▁sk ip ▁out ▁before ▁Tom ▁gets ▁back .	▁ 咱 在 汤姆 回来 之前 开 溜 吧 。
▁How ▁do ▁I ▁sign ▁up ?	▁我 怎样 报 名 参加 呢 ?
▁Tom ▁has ▁never ▁been ▁willing ▁to ▁help ▁us ▁before .	▁汤姆 以前 从不 这样 愿意 幚 我们 。
▁A ▁light ▁b ul b ▁give s ▁light .	▁ 灯 泡 发 光 。
▁It ' s ▁going ▁to ▁rain , ▁for ▁sure .	▁要 下雨了 , 我 敢 肯定 。
▁May ▁I ▁have ▁some ▁more ▁coffee ?	▁我可以 再 要 些 咖啡吗 ?
▁Thank ▁you ▁for ▁everything .	▁ 为 一切 感谢 你 。
▁Mary ▁went ▁down ▁to ▁the ▁kitchen .	▁玛丽 下 楼 到 厨房 。
▁I ▁have ▁two ▁brothers ▁and ▁three ▁sisters .	▁我有 两个 兄弟 和 三个 姐妹 。
▁I ▁think ▁you ' re ▁d umb .	▁我认为你 傻 。
▁There ▁was ▁a ▁cottage ▁on ▁the ▁side ▁of ▁the ▁hill .	▁山 坡 上 有一 间 村 屋 。
▁I ▁read ▁about ▁him ▁in ▁the ▁newspaper .	▁我在 报纸 上 读 到 有关 他的 消息 。
▁I ▁have ▁so ▁many ▁clothes ▁I ▁don ' t ▁know ▁what ▁to ▁wear ▁tomorrow .	▁我有 那么多 衣服 , 以至于 我 不知道 明天 穿 什么 了 。
▁S ha ke ▁the ▁bottle ▁before ▁us ing .	▁ 使用 前 摇 动 一下 瓶子 。
▁C le ar ly ▁you ▁are ▁mist aken .	▁ 显然 的 , 你 错了 。
▁Where ▁are ▁you ▁going ?	▁你们 去哪里 ?
▁I ▁saw ▁him ▁swim ▁across ▁the ▁river .	▁我看见他 游 过了 河 。
▁I ▁like ▁your ▁house .	▁我喜欢 你的 房子 。
▁That ▁past ure ▁is ▁ten ▁ac res .	▁那个 牧 场 有 十 英 亩 大 。
▁There ▁was ▁a ▁cold ▁wind ▁bl ow ing ▁from ▁the ▁n ort h .	▁有 一 阵 从 北 边 吹 来的 冷 风 。
▁I ' m ▁glad ▁we ▁h ired ▁you ▁for ▁this ▁job .	▁我很高兴 我们 录 用 了 你来 担 任 这份工作 。
▁H un ger ▁is ▁the ▁best ▁sa u ce .	▁对于 一个 饥饿 的人 来说 , 任何 食物 都是 美味 。
▁Don ' t ▁throw ▁tr ash ▁here .	▁别 在这儿 扔 垃 圾 。
▁She ▁cal med ▁down .	▁她 冷静 下来 。
▁Put ▁some ▁water ▁into ▁the ▁v ase .	▁在 花 瓶 里 装 些 水 。
▁I ▁bought ▁a ▁second ▁bad m int on ▁r acket ▁for ▁myself , ▁but ▁I ▁forgot ▁to ▁buy ▁a ▁shut tle c ock .	▁我为 自己 买了 副 羽 毛 球拍 , 但我 忘记 买 羽 毛 球 了 。
▁On ce ▁in ▁a ▁while , ▁we ▁should ▁take ▁a ▁step ▁back ▁and ▁think .	▁有 时候 , 我们 应该 后 退 一 步 想 一 想 。
▁I ▁cl a pped .	▁我 拍 手 。
▁Europe ans ▁like ▁to ▁drink ▁wine .	▁ 欧洲 人 喜欢 喝酒 。
▁It ' s ▁fun ▁to ▁ride ▁a ▁mot orc ycle .	▁ 骑 摩 托车 很有趣 。
▁You ' ll ▁find ▁this ▁map ▁very ▁useful .	▁你会 发现 这张 地图 非常 有 用 。
▁I ▁am ▁conv in ced ▁that ▁things ▁will ▁change ▁for ▁the ▁better .	▁我 深 信 事情 会 往 更好的 方 向 转 变 。
▁The ▁s en ator ▁was ▁c ens ured ▁by ▁the ▁c ong ress ion al ▁ eth ics ▁comm itt ee .	▁ 议 员 受 到了 议 会 道 德 委 员 会 的 谴 责 。
▁I ▁want ▁Tom ▁to ▁let ▁Mary ▁finish .	▁我希望汤姆 让 玛丽 完成 。
▁He ▁is ▁known ▁as ▁a ▁great ▁poet .	▁他以 一个 伟大的 诗人 闻 名 。
▁Tom ▁pretty ▁much ▁forgot ▁about ▁the ▁meeting .	▁汤姆 差不多 忘了 开 会 的事 儿 。
▁I ▁think ▁my ▁right ▁arm ▁is ▁broken .	▁我想 我的 右 手臂 断了 。
▁It ▁is ▁imp er ative ▁for ▁you ▁to ▁act ▁at ▁once .	▁您 必须 马上 行动 。
▁We ▁don ' t ▁have ▁another ▁choice .	▁我们没有 别 的 选择 。
▁His ▁company ▁didn ' t ▁sur v ive ▁the ▁cr is is .	▁他的 公司 没有 从 危 机 中 幸 存 。
▁You ▁must ▁be ▁careful ▁of ▁the ▁traffic ▁when ▁you ▁cross ▁the ▁street .	▁ 横 穿 马路 时 你要 留 心 。
▁W ash ▁your ▁fe et .	▁ 洗 您的 脚 。
▁He ▁wants ▁to ▁work ▁in ▁a ▁hospital .	▁他想 在医院 工作 。
▁He ▁found ▁me ▁a ▁good ▁seat .	▁他 帮我 找到了 一个 好 位 子 。
▁It ' s ▁lunch ▁time .	▁ 午餐 时间 到了 。
▁This ▁is ▁a ▁pencil .	▁这是 一支 铅笔 。
▁Tom ▁has ▁something ▁else ▁to ▁say .	▁汤姆 还有 想 说 的事 。
▁Is ▁anything ▁b other ing ▁you ?	▁有 什么事 让你 烦 心 吗 ?
▁I ▁can ' t ▁find ▁my ▁umbrella ▁anywhere .	▁我 任何 地方 都 找不到 我的 伞 。
▁I ▁am ▁accustomed ▁to ▁working ▁hard .	▁我 习惯 辛 勤 努力地 工作 。
▁The ▁room ▁was ▁ill um in ated ▁with ▁red ▁lights .	▁这个 房间 被 红色的 灯 照 亮 了 。
▁She ' s ▁sitting ▁on ▁the ▁bench .	▁她 坐在 长 椅上 。
▁Tom ▁can ' t ▁get ▁his ▁car ▁started .	▁汤姆没 法 发 动 他的车 。
▁Come ▁on . ▁I ▁want ▁to ▁show ▁you ▁something .	▁来 吧 。 我想 让你 看 点东西 。
▁Why ▁do ▁you ▁need ▁to ▁read ▁such ▁a ▁book ?	▁为什么 你要 读 这样 一本书 ?
▁How ▁long ▁did ▁you ▁live ▁there ?	▁你 住在 那里 多久 了 ?
▁I ▁mist ook ▁him ▁for ▁his ▁brother .	▁我把 他 误 认为 是 他的 兄弟 。
▁I ▁can ▁open ▁the ▁window .	▁我可以 打开 这 扇 窗 。
▁We ▁are ▁sorry ▁we ▁can ' t ▁help ▁you .	▁我们很 遗憾 没 能 帮助 你们 。
▁This ▁is ▁your ▁only ▁chance .	▁这是你 唯一 的 机会 。
▁They ▁went ▁to ▁Ch ic ag o ▁by ▁car .	▁他们 坐 车 去 芝 加 哥 。
▁I ▁worked ▁on ▁the ▁far m ▁all ▁day .	▁我 整天 在 农 场 上 工作 。
▁You ▁should ▁come ▁back ▁immediately .	▁你应该 马上 回来 。
▁His ▁wife ▁is ▁in ▁the ▁hospital ▁because ▁she ▁was ▁injured ▁in ▁a ▁car ▁cr ash .	▁他的 妻子 在医院 里 因为 她在 一 场 车 祸 中 受伤 了 。
▁Tom ▁is ▁able ▁to ▁come ▁to ▁our ▁party ▁tomorrow .	▁汤姆 明天 能 来 我们的 聚会 。
▁L end ▁me ▁your ▁book , ▁please .	▁请 ▁ 借我 你的 书 。
▁Tomorrow ▁I ' m ▁going ▁to ▁S han g ha i .	▁我明天 要去 上 海 。
▁I ▁am ▁used ▁to ▁hearing ▁the ▁train ▁pass ▁by ▁my ▁house .	▁我已经 习惯 了 家 门口 过 火车 的声音 了 。
▁Stop ▁joking ▁around .	▁不要 随便 开玩笑 。
▁Why ▁can ' t ▁we ▁go ▁and ▁see ▁Tom ?	▁ 为甚么 我们 不能 去看 汤姆 ?
▁Mary ▁closed ▁the ▁door ▁quiet ly .	▁玛丽 悄 悄 地 关 上了 门 。
▁Her ▁son ▁is ▁a ▁g en i us .	▁她 儿子 是个 天 才 。
▁He ▁r ushed ▁out ▁of ▁the ▁office .	▁他 急 忙 出了 办公室 。
▁I ▁relax ed ▁at ▁home ▁last ▁Sunday .	▁我上 个 星期天 在家里 放 轻松 。
▁That ▁book ' s ▁over ▁here .	▁那 本书 在这里 。
▁Well , ▁let ' s ▁go .	▁好 吧 , 我们 走 吧 。
▁Harvard ▁was ▁found ed ▁in ▁16 3 6 .	▁ 哈佛 始 建 于 16 3 6 年 。
▁What ' s ▁your ▁native ▁language ?	▁你的 母语 是什么 ?
▁Tom ▁is ▁reading ▁a ▁book ▁in ▁his ▁room .	▁汤姆 正在 自己 房间里 看书 。
▁Someone ▁ate ▁all ▁my ▁cup c akes .	▁ 某 人 把我的 杯 形 蛋糕 吃 完了 。
▁I ' m ▁looking ▁for ▁a ▁place ▁to ▁sit .	▁我正在 找 个 地方 坐 下 。
▁I ▁war ned ▁him , ▁but ▁he ▁ ign ored ▁the ▁war ning .	▁我 警告 过 他 , 但他 不 理 会 警告 。
▁I ▁have ▁already ▁finished ▁reading ▁this ▁book .	▁我已经 读 完了 这本书 。
▁Is ▁it ▁OK ▁if ▁I ▁go ▁out ▁with ▁Tom ?	▁我 跟汤姆 外出 行 吗 ?
▁Look ▁out !	▁当 心 !
▁I ▁have ▁to ▁take ▁my ▁medicine ▁every ▁six ▁hours .	▁我每 六 小时 要 服 一次 药 。
▁He ▁gave ▁me ▁his ▁stam p ▁of ▁appro v al .	▁他 给了我 正 式 批 准 。
▁He ▁hit ▁his ▁head ▁against ▁a ▁rock .	▁他的 头 撞 到 了一 块 岩 石 。
▁Why ▁are ▁you ▁crying ?	▁你为什么 哭 ?
▁Is ▁there ▁any ▁mail ▁for ▁me ▁today ?	▁今天 有 给我的 邮 件 吗 ?
▁I ' d ▁buy ▁a ▁new ▁house ▁if ▁I ▁had ▁the ▁money .	▁如果我 有钱 , 我会 买 一个 新 房子 。
▁Is ▁it ▁far ?	▁ 远 吗 ?
▁What ▁will ▁you ▁have ▁for ▁lunch ▁today ?	▁你今天 午餐 吃什么 ?
▁Give ▁me ▁something ▁to ▁write ▁on .	▁给我 一些 我可以 在 上面 写字 的东西 。
▁Tom ▁said ▁he ' ll ▁ask ▁Mary ▁to ▁do ▁that .	▁汤姆说他 会 让 玛丽 去做 。
▁We ' ll ▁talk ▁about ▁this ▁later .	▁我们 晚 会 再 谈 这事 。
▁Don ' t ▁begin ▁without ▁me .	▁我不 在 就 别 开始 。
▁Let ' s ▁go ▁out ▁and ▁eat ▁dinner ▁together ▁from ▁time ▁to ▁time .	▁让我们 偶尔 出去 一起 吃 晚餐 。
▁Sh ut ▁the ▁door ▁on ▁your ▁way ▁out .	▁出去 的时候 把 门 关上 。
▁These ▁flowers ▁have ▁a ▁un i qu e ▁smell .	▁这些 花 有一 种 独 特 的 气 味 。
▁We ' re ▁still ▁doing ▁well .	▁我们 依 然 做 得很好 。
▁My ▁gu m s ▁are ▁b le ed ing .	▁我的 牙 龈 流 血 。
▁The ▁meal ▁satisfied ▁his ▁hun ger .	▁这 顿 饭 让他 充 饥 解 饿了 。
▁She ▁died ▁of ▁stomach ▁cancer .	▁她 死于 胃 癌 。
▁Tom ▁will ▁never ▁do ▁it ▁again .	▁汤姆 再 也不 做了 。
▁Her ▁husband ▁is ▁an ▁excellent ▁cook .	▁她 丈夫 是个 优 秀 的 厨师 。
▁How ▁did ▁you ▁get ▁back ▁so ▁soon ?	▁你怎么 回来 得 这么 快 ?
▁I ' ve ▁run ▁out ▁of ▁money .	▁我 钱 已经 用 完了 。
▁You ▁need ▁to ▁have ▁friends ▁who ▁can ▁help ▁you ▁out .	▁你需要 可以 帮助 你的 朋友 。
▁I ' ll ▁give ▁you ▁anything ▁that ▁you ▁want .	▁我会给你 任何 你想要 的东西 。
▁What ▁kind ▁of ▁person ▁is ▁she ?	▁她是 怎样 的人 呢 ?
▁The ▁number ▁of ▁people ▁on ▁Facebook ▁is ▁great er ▁than ▁the ▁population ▁of ▁the ▁United ▁States .	▁Facebook 的 用 户 比 美国人 口 还 多 。
▁Would ▁you ▁carry ▁my ▁l ugg age ▁up st airs ?	▁你可以 把我的 行李 拿 到 楼 上 吗 ?
▁I ▁only ▁spent ▁three ▁dollars .	▁我只 花了 三 美元 。
▁The ▁problem ▁was ▁that ▁I ▁had ▁nothing ▁to ▁say ▁to ▁him .	▁问题 是 ▁我没 什么 要 跟他 说的 。
▁How ▁much ▁is ▁this ▁hat ?	▁这 顶帽子 多少钱 ?
▁The ▁matter ▁has ▁not ▁been ▁set t led ▁yet .	▁问题 还 没有 解决 。
▁Are ▁you ▁sure ▁Tom ▁will ▁come ▁back ?	▁你确定 汤姆会 回来 吗 ?
▁Can ▁we ▁go ▁back ▁now ?	▁我们现在 能 回 去 吗 ?
▁She ▁waited ▁for ▁hours ▁and ▁hours .	▁她 等了 好 几个小时 。
▁It ▁really ▁is ▁very ▁ann oy ing .	▁ 真是 烦 死了 。
▁If ▁she ▁was ▁dis p leas ed , ▁she ▁never ▁showed ▁it .	▁如果 她 不高兴 , ▁她 从来不 表现 出来 。
▁Tom ▁went ▁to ▁Boston ▁for ▁a ▁week .	▁Tom 每个 礼拜 都 回 去 一次 波士顿 。
▁Does ▁Tom ▁speak ▁French ▁better ▁than ▁Mary ?	▁汤姆 说法语 比 玛丽 好吗 ?
▁His ▁mother ▁sat ▁up ▁all ▁night ▁waiting ▁for ▁her ▁son .	▁他的 妈妈 坐 了一 整夜 , 等 她的 儿子 。
▁They ▁will ▁te ar ▁down ▁the ▁old ▁building ▁in ▁two ▁days .	▁他们 将在 两天 内 拆 除 这 栋 旧 的 建筑 物 。
▁She ▁knows ▁how ▁to ▁play ▁the ▁guitar .	▁她 知道 如何 弹吉他 。
▁Go ▁with ▁these ▁men .	▁ 跟 这些 人 走 。
▁Don ' t ▁you ▁remember ▁what ▁you ▁said ?	▁ 自己 说过 的话 都不 记得 了吗 ?
▁Tom ▁and ▁I ▁were ▁born ▁in ▁the ▁same ▁city .	▁汤姆和我 生 在 同 一个 城市 。
▁Mary ▁has ▁a ▁bad ▁back . ▁It ' s ▁hard ▁for ▁her ▁to ▁lift ▁things .	▁玛丽 的 背 不好 , ▁她 很难 把 东西 举 起来 。
▁What ' s ▁in ▁front ▁of ▁you ?	▁在你 面前 是什么 东西 ?
▁This ▁is ▁the ▁cheap est ▁store ▁in ▁town .	▁这是 镇上 最 便宜 的 商店 。
▁You ▁should ▁go .	▁你应该 去 。
▁The ▁equ ator ▁div ides ▁the ▁gl obe ▁into ▁two ▁he m is p here s .	▁ 赤 道 把 地球 分 为 两个 半 球 。
▁Were ▁you ▁on ▁time ▁for ▁work ▁today ?	▁你今天 准时 上班 了吗 ?
▁This ▁is ▁a ▁very ▁interesting ▁book .	▁这是 一本 非常有趣 的书 。
▁P art ▁of ▁his ▁story ▁is ▁true .	▁他的 故事 一 部分 是真的 。
▁I ▁think ▁I ' ll ▁be ▁able ▁to ▁deal ▁with ▁that .	▁我认为 我能 做 好 。
▁I ' m ▁bad ▁at ▁sports .	▁我不 擅长 运动 。
▁Are ▁these ▁your ▁things ?	▁这些 是你的 东西 吗 ?
▁He ▁se ld om ▁comes ▁to ▁see ▁me .	▁他很 少 来看我 。
▁Thank ▁you ▁for ▁your ▁inv itation .	▁ 感谢 您的 邀请 。
▁Why ▁are ▁you ▁busy ▁today ?	▁你今天 为什么 忙 ?
▁Mother ▁T e res a ▁was ▁given ▁the ▁Nob el ▁prize .	▁ 特 蕾 莎 修 女 被 授 予 诺 贝 尔 奖 。
▁He ▁was ▁app oin ted ▁amb ass ad or ▁to ▁B rit ain .	▁他被 任 命 为 驻 英国 大 使 。
▁I ▁missed ▁my ▁chance .	▁我 错过 了我的 机会 。
▁Is ▁this ▁the ▁bus ▁to ▁O x f ord ?	▁这是 去 牛 津 大学 的 车吗 ?
▁I ▁can ' t ▁find ▁my ▁suitcase .	▁我 找不到 我的 手提 箱 。
▁Her ▁dream ▁is ▁to ▁visit ▁Paris .	▁她的 梦想 是 参观 巴黎 。
▁L ear ning ▁how ▁to ▁swim ▁is ▁very ▁simple .	▁ 学 游泳 非常 简单 。
▁A ▁rock ▁fell ▁from ▁above .	▁一 块 岩 石 从 上面 落 下 。
▁Can ▁you ▁solve ▁this ▁p u z z le ?	▁你能 解 开 这个 谜 吗 ?
▁Take ▁off ▁your ▁socks , ▁please .	▁请 脱 下 你的 袜子 。
▁The ▁most ▁lo g ical ▁place ▁to ▁keep ▁your ▁shoes ▁is ▁near ▁the ▁door .	▁ 最 合 逻 辑 的 放 鞋 处 是 门口 附近 。
▁M at hematics ▁is ▁an ▁easy ▁subject ▁for ▁me .	▁ 数学 对我来说 是一个 容易 的 科目 。
▁She ▁was ▁not ▁a ▁very ▁good ▁pian ist .	▁她 不是 一个 很好的 钢琴 家 。
▁We ' re ▁classm ates .	▁我们是 同学 。
▁They ▁made ▁their ▁way ▁toward ▁the ▁town .	▁他们 往 小 镇 方 向 去了 。
▁That ▁house ▁belong s ▁to ▁him .	▁这 栋房子 是 属于 他的 。
▁He ▁graduated ▁from ▁high ▁school ▁this ▁spring .	▁ 今年 春天 他 从 高中 毕业 了 。
▁Where ▁did ▁you ▁get ▁your ▁hair ▁cut ?	▁你 在哪里 剪 头发 ?
▁Where ▁is ▁my ▁book ?	▁我的 书 在哪 ?
▁I ▁met ▁a ▁friend ▁of ▁Mary ' s .	▁我 遇到了 玛丽的 一位 朋友 。
▁G old ▁is ▁much ▁heav ier ▁than ▁water .	▁ 金 子 比 水 重 得多 。
▁Look , ▁it ' s ▁my ▁problem .	▁看 , 这 是我的 问题 。
▁Everyone ▁has ▁st ren g th s ▁and ▁we ak ness es .	▁每个人都 有 他的 长 处 和 短 处 。
▁Tom ▁is ▁too ▁tired ▁to ▁help ▁you ▁do ▁that ▁today .	▁汤姆 今天 太 累 , 不能 帮你 。
▁We ▁should ▁b an ▁ad ver t is ing ▁a im ed ▁toward s ▁children .	▁我们应该 禁 止 针 对 儿童 的 广告 。
▁I ▁sell ▁clot hing ▁on l ine .	▁我在 网 路 上 卖 衣服 。
▁She ▁got ▁all ▁doll ed ▁up ▁for ▁her ▁big ▁date .	▁为了 她的 重要 约会 , 她 精 心 打 扮 了一下 。
▁I ▁can ' t ▁believe ▁it !	▁我没 法 相信 !
▁The ▁world ▁is ▁chang ing ▁every ▁minute .	▁世界 每 一 分钟 都在 改变 。
▁" I ▁don ' t ▁want ▁to ▁go ▁right ▁now ." ▁" W h y ▁not ?"	▁" 你 现在 不要 出去 。" ▁" 为什么 不要 ?"
▁The ▁weather ▁is ▁nice ▁tonight .	▁今晚 天 公 作 美 。
▁Acc ident s ▁happen .	▁事故 发生 。
▁We ▁don ' t ▁care ▁what ▁he ▁does .	▁我们不 在乎 他 做什么 。
▁I ' m ▁just ▁another ▁man .	▁我只 是个 大 众 脸 。
▁She ' ll ▁be ▁getting ▁married ▁next ▁year .	▁她 明年 将 要 结婚 。
▁How ▁did ▁you ▁meet ▁Tom ?	▁你是 怎么 见到 汤姆的 ?
▁I ▁can ' t ▁work ▁for ▁this ▁company ▁anymore .	▁我没 法 再 在这 家 公司 里面 工作了 。
▁I ▁want ▁more ▁det ail ed ▁information .	▁我要 更多 详 细 的 讯 息 。
▁No ▁one ▁can ▁keep ▁me ▁from ▁going ▁there .	▁没人 能 阻止 我去 那儿 。
▁The ▁sky ▁is ▁clear ▁almost ▁every ▁day .	▁天空 几乎 每天 是 晴 朗 的 。
▁He ▁does ▁not ▁like ▁being ▁pun ished .	▁他 不喜欢 被 惩罚 。
▁You ▁should ▁have ▁stayed ▁in ▁the ▁car .	▁你该 留在 车 里 。
▁Close ▁your ▁eyes .	▁ 闭 上你的 眼睛 。
▁Let ' s ▁play ▁baseball ▁after ▁school .	▁让我们 放学后 打棒球 。
▁He ▁pretended ▁to ▁be ▁a ▁doctor .	▁他 假装 是一名 医生 。
▁He ▁is ▁not ▁a ▁singer , ▁but ▁an ▁a ctor .	▁他不是 歌手 , 但 是个 演员 。
▁I ' d ▁like ▁to ▁inv ite ▁you ▁to ▁the ▁party .	▁我想 请你 参加 派对 。
▁I ' d ▁do ▁anything ▁for ▁Tom .	▁我会 为 汤姆 做 任何事 。
▁He ▁went ▁there ▁ten ▁years ▁ago .	▁他 十 年前 去了 那 ‘ 里 。
▁Tom ▁check ed ▁the ▁TV ▁sc hed ule ▁to ▁see ▁what ▁was ▁on .	▁汤姆 检查 电视 时间 表 , 看看 在 上 映 什么 。
▁I ' m ▁prepared ▁to ▁accept ▁the ▁con se qu en ces .	▁我 准备好了 承 担 后 果 。
▁I ▁l ent ▁him ▁a ▁CD .	▁我 借 给他 一 盘 CD 。
▁The ▁university ▁was ▁found ed ▁by ▁his ▁father ▁twenty ▁years ▁ago .	▁ 大学 在 20 年前 由 他的 父亲 建 立 。
▁I ▁can ' t ▁believe ▁that .	▁我不能 相信 。
▁He ' ll ▁be ▁back ▁home ▁soon .	▁他 很快就会 回家 。
▁Tom ▁isn ' t ▁an ▁an ge l .	▁汤姆不是 天 使 。
▁I ▁have ▁been ▁in ▁Japan ▁for ▁two ▁months .	▁我在 日本 已经 两个 月 了 。
▁It ' s ▁the ▁only ▁thing ▁I ▁can ▁think ▁of .	▁这是我 唯一 能 想到 的事 了 。
▁He ' s ▁my ▁M r . ▁R ight .	▁他 是我的 如 意 郎 君 。
▁B y ▁the ▁way , ▁are ▁you ▁free ▁tonight ?	▁ 顺 便 问 一 句 , 你 今晚 有空 吗 ?
▁We alth ▁does ▁not ▁always ▁bring ▁us ▁happ iness .	▁ 财 富 并不总是 为 我们 带来 快乐 。
▁They ▁say ▁that ▁golf ▁is ▁very ▁popular ▁in ▁Japan .	▁他们 说 高尔夫 在日本 很 流行 。
▁My ▁daughter ▁graduated ▁from ▁the ▁university ▁today .	▁我 女儿 今天 大学 毕业 。
▁Tom ▁wants ▁to ▁sleep ▁on ▁it .	▁汤姆想 在 它 上面 睡觉 。
▁He ▁collect ed ▁bit s ▁of ▁information .	▁他 收集 了一些 讯 息 。
▁It ▁was ▁raining ▁when ▁we ▁arrived .	▁我们 到 的时候 正在 下雨 。
▁The ▁girl ▁is ▁small ▁for ▁her ▁age .	▁就 她的 年龄 来说 , 这个 女孩 算 是 矮 小 的 。
▁Do ▁you ▁go ▁to ▁school ▁on ▁Saturday ?	▁你 星期 六 去上学 吗 ?
▁Tom ▁has ▁to ▁do ▁that ▁right ▁away .	▁汤姆 必须 马上 去做 。
▁He ▁is ▁a ▁Japanese ▁boy .	▁他是个 日本 少 年 。
▁I ▁am ▁tired ▁of ▁homework .	▁我厌倦 了 功课 。
▁If ▁he ' s ▁fluent ▁in ▁English , ▁I ' ll ▁h ire ▁him .	▁如果 他 说得 一 口 流利 的 英文 , 我就 请 他 为我 工作 。
▁Ind ia ▁g ained ▁ind ep end ence ▁from ▁B rit ain ▁in ▁19 4 7 .	▁ 印度 于 19 4 7 年 脱 离 英国 获 得 独 立 。
▁He ▁is ▁used ▁to ▁speaking ▁in ▁public .	▁他 习惯 在 公 众 场合 说话 。
▁A ▁str ing ▁of ▁dis aster s ▁str uck ▁the ▁reg ion .	▁一 连 串 的 灾 难 袭 击 这个 地 区 。
▁You ▁should ▁always ▁do ▁your ▁best .	▁你应该 永远 尽力 而为 。
▁He ▁cle ared ▁his ▁th ro at .	▁他 清 了 清 喉 咙 。
▁Those ▁dogs ▁are ▁big .	▁那些 狗 都 很大 。
▁I ▁would ▁like ▁to ▁leave ▁this ▁town ▁and ▁never ▁come ▁back .	▁我希望 离开 这个 村 子 并且 再也 不要 回来 。
▁Are ▁we ▁done ?	▁我们 完成 了吗 ?
▁You ▁are ▁bl us hing .	▁你 脸 红 了 。
▁Do ▁you ▁have ▁a ▁list ▁of ▁hotel s ?	▁你有 旅馆 名 录 吗 ?
▁What ' s ▁happened ?	▁ 怎么了 ?
▁O bey ▁your ▁teacher s .	▁要 听 老师 的话 。
▁Give ▁it ▁back .	▁还 回 去
▁He ▁introdu ced ▁me ▁to ▁his ▁parents .	▁他把 我 介绍 给他的 父母 认识 。
▁What ▁time ▁does ▁the ▁play ▁begin ?	▁ 演 出 什么时候开始 ?
▁He ▁died ▁yesterday .	▁他昨天 去世了 。
▁There ▁is ▁a ▁mil it ary ▁base ▁near ▁here .	▁这 附近 有一个 军 事 基 地 。
▁G ener ally , ▁men ▁run ▁f aster ▁than ▁women .	▁一 般 来说 , ▁ 男人 比 女人 跑得 快 。
▁What ▁did ▁you ▁do ▁over ▁the ▁weekend ?	▁你 整个 周末 做了什么 ?
▁Children ▁really ▁like ▁playing ▁on ▁the ▁beach .	▁孩子们 非常 喜欢 在 海滩 上 玩 耍 。
▁They ▁closed ▁their ▁eyes .	▁他们 闭 上 眼睛 。
▁They ▁gave ▁a ▁big ▁party ▁for ▁me .	▁他们 为我 办 了一个 盛 大的 派对 。
▁There ▁are ▁no ▁cloud s ▁in ▁the ▁sky .	▁天 上 没有 云 。
▁Hey ▁you ! ▁Please ▁wait .	▁ 嘿 , 你 ! 请 稍 候 。
▁I ' m ▁just ▁looking , ▁thank ▁you .	▁我只是 看看 , ▁谢谢你 。
▁You ' ve ▁been ▁had .	▁你们 被 骗 了 。
▁How ▁far ▁away ▁are ▁we ?	▁我们 有多 远 了 ?
▁The ▁sun ▁set s ▁earlier ▁in ▁the ▁winter .	▁在 冬天 , 太阳 下 山 比 往 常 更 早 。
▁Don ' t ▁ask ▁questions . ▁Just ▁follow ▁me .	▁别 问 问题 。 跟着 我就 行 。
▁How ▁can ▁that ▁be ▁possible ?	▁那 怎么 可能 ?
▁I ' m ▁at ▁work ▁now , ▁so ▁I ' ll ▁call ▁you ▁later .	▁我现在 在 上班 , 所以 晚 点 打 给你 。
▁Tom ▁loves ▁to ▁sing .	▁汤姆 爱 唱歌 。
▁I ▁did ▁not ▁expect ▁it ▁to ▁be ▁that ▁big .	▁我没 想到 它 有 那么 大 。
▁She ▁c ared ▁for ▁her ▁father ▁until ▁his ▁death .	▁她 照顾 她的 父亲 直 到他 去世 。
▁We ▁lost ▁our ▁cat ▁and ▁Tom ▁found ▁it ▁for ▁us .	▁我们 弄 丢了 车 , Tom 帮我们 找 了 回来 。
▁If ▁you ▁do ▁not ▁have ▁this ▁program , ▁you ▁can ▁down l o ad ▁it ▁now .	▁ 假 如 你 没有 这个 程 序 , 你 现在 就 可以 去 下 载 。
▁I ▁managed ▁to ▁get ▁there ▁in ▁time .	▁我 设法 及时 到那里 。
▁The ▁building ▁is ▁one ▁hundred ▁met ers ▁high .	▁该 建筑 高 一 百 公 尺 。
▁Children ▁like ▁fruit ▁juice .	▁孩子们 喜欢 果汁 。
▁You ▁are ▁a ▁good ▁cook , ▁aren ' t ▁you ?	▁你很 会 做 菜 , 不是吗 ?
▁Tom ▁didn ' t ▁know ▁what ▁Mary ▁thought ▁about ▁it .	▁汤姆不知道 玛丽 对 它 怎么想 。
▁A ct ually , ▁I ' m ▁not ▁suggest ing ▁anything .	▁ 实际上 , 我没有 建议 甚么 。
▁She ▁mist ook ▁me ▁for ▁my ▁brother .	▁她把 我 误 认为 是我的 兄弟 。
▁I ▁still ▁can ' t ▁believe ▁I ▁did ▁it .	▁我 仍 旧 无法 相信 我 居 然 做了 这种 事 。
▁The ▁prison er ▁was ▁brought ▁before ▁a ▁j ud ge .	▁这个 囚 犯 被 带 到 法 官 面前 。
▁You ' d ▁better ▁not ▁speak .	▁你最好不要 说 。
▁Why ▁do ▁you ▁have ▁two ▁cars ?	▁他 为什么 有 两 辆车 ?
▁What ▁is ▁it ▁you ▁want ▁to ▁know ?	▁你想 知道 什么 ?
▁What ▁did ▁you ▁buy ?	▁你 买 了什么 ?
▁You ▁must ' ve ▁been ▁surprised ▁to ▁meet ▁your ▁teacher ▁in ▁such ▁a ▁place .	▁在 那种 地方 碰 到 你的 老师 , 你应该 很 惊讶 吧 。
▁When ▁do ▁you ▁pract ice ▁the ▁piano ?	▁你什么时候 练习 弹钢琴 ?
▁Keep ▁to ▁the ▁right .	▁ 靠 右 侧 通 行 。
▁This ▁is ▁a ▁book ▁about ▁stars .	▁这是 本关于 星星 的书 。
▁I ▁don ' t ▁have ▁a ▁computer ▁at ▁home .	▁我家 没有 电脑 。
▁Your ▁problem ▁is ▁sim il ar ▁to ▁mine .	▁你的 问题 和 我的 相 似 。
▁I ▁think ▁Tom ' s ▁che ating .	▁我觉得 汤姆 有 外 遇 。
▁I ' m ▁gr ate ful ▁for ▁that .	▁我对 那事 很 是 感 激 。
▁Is ▁the ▁door ▁open ?	▁ 门 开著 吗 ?
▁How ▁about ▁call ing ▁it ▁a ▁day ?	▁今天 就 做到 这里 如何 ?
▁T en ▁prison ers ▁broke ▁out ▁of ▁j ail .	▁十 名 囚 犯 逃 狱 了 。
▁Did ▁you ▁do ▁your ▁homework ▁by ▁yourself ?	▁你 自己做 回家 作业 的吗 ?
▁I ▁don ' t ▁like ▁this ▁jacket .	▁我不喜欢 那 件 夹 克 。
▁They ▁got ▁married ▁and ▁set t led ▁near ▁Boston .	▁他们 结 了 婚 并 定 居 在波士顿 附近 。
▁They ▁are ▁very ▁big .	▁他们 非常 大 。
▁I ▁have ▁a ▁very ▁s ore ▁arm ▁where ▁you ▁hit ▁me .	▁你 打 在 我 手臂 上 的地方 超 级 痛 。
▁Tom ▁told ▁Mary ▁he ▁had ▁a ▁lot ▁of ▁money .	▁汤姆 告诉玛丽 他 有很多 钱 。
▁The ▁sky ▁is ▁full ▁of ▁stars .	▁天空 中 繁 星 点 点 。
▁Close ▁your ▁mouth .	▁ 闭 上你的 嘴 。
▁I ▁don ' t ▁often ▁do ▁that ▁by ▁myself .	▁我不 经常 自己 去做 。
▁If ▁her ▁temper ature ▁goes ▁up , ▁send ▁for ▁the ▁doctor .	▁如果 她的 体 温 上 升 , ▁ 派 人 去 请 医生 来 。
▁I ▁guess ▁that ▁would ▁be ▁all ▁right .	▁我想 那 应该 没关系 的 。
▁I ▁can ' t ▁believe ▁that ▁you ▁were ▁the ▁smart est ▁kid ▁in ▁your ▁class .	▁我不 敢 相信你 是 你们 班 里面 最 聪明 的 孩子 。
▁Nobody ▁knows ▁what ▁will ▁happen ▁in ▁the ▁future .	▁人 不知道 未 来 可能 发生 什么事 。
▁She ▁has ▁been ▁to ▁Paris .	▁她 去过 巴黎 。
▁Where ' s ▁the ▁nearest ▁telephone ▁bo oth ?	▁最近的 电话 亭 在哪里 ?
▁She ' s ▁asking ▁how ▁that ' s ▁possible .	▁她问 这 怎么 可能 。
▁See ▁you ▁soon !	▁一 会儿 见 !
▁He ▁was ▁n amed ▁after ▁his ▁grandfather .	▁他以 他 祖父 的名字 被 命 名 。
▁You ' ve ▁been ▁late ▁for ▁school ▁more ▁often ▁than ▁before .	▁你 比 以前 更 容易 上课 迟到了 。
▁Tom ▁has ▁recently ▁become ▁forget ful .	▁Tom 最近 变得 健 忘了 。
▁Please ▁show ▁me ▁what ▁to ▁do ▁next .	▁请让我 看看 下一步 该 做什么 。
▁Does ▁it ▁sound ▁like ▁I ' m ▁in ▁love ?	▁听 起来 像 是我 恋 爱 了吗 ?
▁I ▁like ▁you .	▁我喜欢 你 。
▁Can ▁you ▁speak ▁English ?	▁你们 会 说英语 吗 ?
▁Be fore ▁this ▁car , ▁I ▁dro ve ▁a ▁N iss an .	▁在这 辆车 之前 , 我 开 的是 辆 日 产 汽车 。
▁English ▁is ▁a ▁very ▁important ▁language ▁in ▁today ' s ▁world .	▁英语 是 当 今 世界上 一 种 非常 重要 的 语言 。
▁She ▁always ▁smil es ▁at ▁me .	▁她总是 对我 微笑 。
▁Don ' t ▁worry ▁about ▁it .	▁不要 担心 它 。
▁He ▁is ▁watching ▁TV .	▁他在 看电视 。
▁A nd ▁everyone ▁has ▁the ▁ab ility ▁to ▁cont ri b ut e .	▁每个人都 有 能力 作 贡 献 。
▁She ▁must ▁be ▁angry ▁with ▁me .	▁她 一定 在 生 我的 气 。
▁This ▁is ▁not ▁a ▁t ig er .	▁这不是 老虎 。
▁How ▁much ▁did ▁the ▁glasses ▁cost ?	▁这 副 眼镜 多少钱 ?
▁Are ▁you ▁really ▁going ▁to ▁London ▁to ▁study ?	▁你 要去 伦敦 读书 是真的 吗 ?
▁My ▁father ▁had ▁me ▁wash ▁the ▁car .	▁父亲 让我 洗 汽车 。
▁My ▁boss ▁made ▁me ▁work ▁over time .	▁我的 老板 要 我 加 班 。
▁Please ▁tell ▁me ▁Tom ▁is ▁OK .	▁请告诉我 汤姆 很好 。
▁Tom ▁is ▁taking ▁a ▁day ▁off .	▁汤姆在 休 一天 假 。
▁I ▁want ▁you ▁guys ▁to ▁do ▁me ▁a ▁favor .	▁我想要 大 家伙 帮我 个 忙 。
▁I ' ll ▁be ▁absent ▁from ▁home ▁in ▁the ▁afternoon .	▁ 下午 我不 在家 。
▁I ▁don ' t ▁like ▁early ▁morning ▁meeting s .	▁我不喜欢 在 清 晨 开 的 会议 。
▁Call ▁me ▁at ▁six ▁tomorrow ▁morning .	▁明天 早上 6 点 给我 打电话 。
▁I ▁have ▁problems , ▁just ▁like ▁everybody ▁else .	▁我有 问题 , 就像 其他人 一样 。
▁I ' m ▁an ▁at he ist .	▁我是 无 神 论 者 。
▁Tom ▁wants ▁a ▁glass ▁of ▁water .	▁汤姆 想要 一杯水 。
▁My ▁aunt ▁made ▁a ▁new ▁skirt ▁for ▁me .	▁我 舅 母 做了一 条新裙子 给我 。
▁The ▁teacher ▁let ▁the ▁boy ▁go ▁home .	▁老师 让 这个 男孩 回家 。
▁This ▁coffee ▁is ▁too ▁hot ▁for ▁me ▁to ▁drink .	▁这 咖啡 热 得 我没 办法 喝 。
▁The ▁world ▁is ▁running ▁out ▁of ▁oil .	▁世界 上的 石 油 快 用 完了 。
▁I ' m ▁always ▁busy ▁with ▁my ▁homework .	▁我总是 忙 于 功课 。
▁He ▁turned ▁to ▁his ▁friends ▁for ▁help .	▁他 寻 求 他的 朋友 的 帮助 。
▁The ▁man ag er ▁appro ved ▁our ▁plan .	▁ 经 理 批 准 了 我们的 计划 。
▁These ▁things ▁aren ' t ▁mine !	▁这些 东西 不是 我的 !
▁He ▁wrote ▁one ▁letter .	▁他 写了一 封信 。
▁My ▁aunt ▁made ▁a ▁new ▁skirt ▁for ▁me .	▁我 阿姨 做了一 条新裙子 给我 。
▁I ▁don ' t ▁like ▁science .	▁我不喜欢 科学 。
▁Go ing ▁out ▁in ▁this ▁rain ▁is ▁out ▁of ▁the ▁question .	▁在 雨 中 走 出去 是不可能的 。
▁When ▁and ▁where ▁is ▁breakfast ▁ser ved ?	▁ 早饭 在 何时 何 地 用 ?
▁He ▁real ized ▁his ▁dream ▁of ▁becom ing ▁an ▁art ist .	▁他 实 现 了 当 兿 术 家 的 梦想 。
▁P l ay ing ▁tennis ▁is ▁a ▁lot ▁of ▁fun .	▁ 打网球 很有趣 。
▁That ▁house ▁is ▁big .	▁那 栋房子 很大 。
▁A ▁par r ot ▁can ▁m im ic ▁a ▁person ' s ▁voice .	▁ 鹦 鹉 会 模 仿 人的 声音 。
▁It ▁is ▁already ▁nine ▁o ' clock .	▁已经 9 点了 。
▁You ▁may ▁sit ▁wherever ▁you ▁like .	▁你喜欢 坐 哪儿 就 坐 哪儿 。
▁The ▁sp ace ▁r ace ▁was ▁an ▁exc it ing ▁time ▁in ▁history .	▁太 空 跑步 是 历史 上 激 动 人 心 的 时 刻 。
▁No ▁one ▁lives ▁in ▁this ▁building .	▁没有人 住在这 栋 楼 里 。
▁Tom ▁complain s ▁all ▁the ▁time .	▁汤姆 老 是 发 牢 骚 。
▁Will ▁six ▁o ' clock ▁suit ▁you ?	▁ 六点 您 行 吗 ?
▁I ▁will ▁make ▁it ▁clear ▁that ▁I ▁won ' t ▁come ▁again .	▁我要 明 确 表示 我不会 再 来了 。
▁He ' s ▁writing ▁a ▁long ▁letter .	▁他 写 长 信 。
▁He ▁mist ook ▁me ▁for ▁my ▁mother .	▁他把 我 误 认为 是我的 母亲 。
▁The ▁lake ▁was ▁fro zen .	▁ 湖 冻 冰 了 。
▁Your ▁glasses ▁fell ▁on ▁the ▁floor .	▁你的 眼镜 掉 在地 上了 。
▁The ▁plane ▁is ▁ready .	▁ 飞机 准备好了 。
▁I ' m ▁going ▁on ▁vacation ▁next ▁week .	▁我 下周 要去 度假 。
▁She ▁may ▁come .	▁她 可以 来 。
▁I ' m ▁sure ▁we ' ll ▁find ▁a ▁sol ution .	▁我 确 信 我们 会 找到 解决 办法 的 。
▁Tom ▁swim s ▁very ▁fast .	▁汤姆 游泳 游得 非常 快 。
▁T e ac her s ▁must ▁understand ▁children .	▁ 教师 必须 了解 孩子 。
▁She ▁has ▁a ▁real ▁kn ack ▁for ▁getting ▁people ▁to ▁do ▁what ▁she ▁wants .	▁她 真的 有 本 事 让 别人 做 她 想 做的事 。
▁This ▁is ▁the ▁very ▁book ▁you ▁wanted .	▁这是你 非常 想要 的书 。
▁He ▁made ▁no ▁m ention ▁of ▁her ▁requ est .	▁他没有 提 到 她的 请 求 。
▁Tom ▁has ▁a ▁pretty ▁big ▁mouth .	▁汤姆 是一个 大 嘴 巴 。
▁I ▁don ' t ▁know ▁if ▁that ' s ▁what ▁Tom ▁wants ▁or ▁not .	▁我不知道 那是 不是 汤姆 想要的 。
▁Keep ▁it ▁up !	▁坚持 。
▁You ' ll ▁b oun ce ▁back .	▁你会 东 山 再 起 的 。
▁He ▁was ▁very ▁busy ▁all ▁day .	▁他 一整天 都 很忙 。
▁Do ▁you ▁know ▁why ▁she ' s ▁so ▁angry ?	▁你知道 她 为什么 这么 生气 吗 ?
▁Please ▁turn ▁on ▁the ▁radio .	▁请 打开 收音机 。
▁She ▁was ▁in ▁a ▁hurry .	▁她在 赶 时间 。
▁I ▁can ▁walk ▁to ▁school ▁in ▁10 ▁minutes .	▁我 走路 10 分钟 能 到 学校 ▁ 。
▁L end ▁me ▁your ▁dictionary , ▁please .	▁请把 你的 字典 借给我 。
▁I ▁don ' t ▁want ▁to ▁talk ▁about ▁the ▁weather .	▁我不想 谈论 天气 。
▁What ▁goes ▁up ▁must ▁come ▁down .	▁ 会 起 必 会 落 。
▁What ▁did ▁you ▁get ▁for ▁Christmas ?	▁你 耶 诞 节 得到了 什么 ?
▁I ▁can ' t ▁sha ke ▁off ▁my ▁cold .	▁我的 感冒 怎么 也 不会 好 。
▁There ▁used ▁to ▁be ▁a ▁prison ▁here .	▁这里 以前 有一 座 监狱 。
▁I ▁feel ▁we ak .	▁我 感到 虚 弱 。
▁I ' ll ▁carry ▁this ▁suitcase ▁for ▁you .	▁我会 帮你 提 这个 手提 箱 。
▁Nobody ▁understood ▁why ▁the ▁ele p han t ▁suddenly ▁turned ▁on ▁its ▁ow ner .	▁没有人 明白 为什么 大 象 突然 攻 击 了 它的 主 人 。
▁Paris ▁is ▁one ▁of ▁the ▁lar gest ▁c ities ▁in ▁the ▁world .	▁ 巴黎 是 世界上 最大的 城市 之一 。
▁An other ▁bottle ▁of ▁wine , ▁please .	▁麻烦 再 一 瓶 葡萄酒 。
▁I ▁don ' t ▁understand ▁music .	▁我不懂 音乐 。
▁Did ▁I ▁say ▁something ▁I ▁shouldn ' t ▁have ?	▁我 说了什么 我不 应该 说 的吗 ?
▁He ' s ▁a ▁good ▁man .	▁他 是个好 人 。
▁She ▁hit ▁him .	▁她 打 了他 。
▁Maybe ▁he ▁won ' t ▁become ▁famous .	▁也许 他 不会 成 名 。
▁I ▁am ▁reading ▁a ▁book ▁now .	▁我现在 正在 读 一本书 。
▁Why ▁did ▁you ▁not ▁tell ▁me ▁the ▁truth ?	▁为什么 你不 告诉我 真相 ?
▁You ▁should ▁quit ▁smoking .	▁你应该 戒烟 。
▁That ' s ▁not ▁fair .	▁那是 不 公平 的 。
▁Don ' t ▁let ▁Tom ▁leave .	▁别 让汤姆 走了 。
▁He ▁held ▁a ▁p ack age ▁under ▁his ▁arm .	▁他 挟 著 一个 包 裹 。
▁I ' ve ▁forgot ten ▁his ▁name .	▁我已经 忘 了他的 名字 。
▁Let ' s ▁walk .	▁我们 走 走 吧 。
▁I ▁left ▁my ▁umbrella ▁in ▁the ▁cab .	▁我把我的 伞 忘 在 计程车 上了 。
▁The ▁bus ▁should ▁be ▁coming ▁soon .	▁ 公车 应该 很快就会 来了 。
▁If ▁he ▁is ▁innocent , ▁then ▁his ▁wife ▁is ▁gu il ty .	▁如果 他是 清 白 的 , 那 他 妻子 就 有 罪 。
▁Tom ▁is ▁divorced ▁and ▁has ▁a ▁daughter .	▁Tom 离婚 了 , 他 有个 女儿 。
▁Tom ▁isn ' t ▁very ▁good ▁at ▁speaking ▁French .	▁汤姆 说法语 不太好 。
▁As ▁a ▁matter ▁of ▁fact , ▁I ▁haven ' t ▁eaten ▁anything ▁since ▁this ▁morning .	▁ 事实 上 , 我 从 今天 早上 开始 没有 吃 任何东西 。
▁H ang ▁on .	▁坚持 。
▁I ▁wake ▁him ▁up ▁at ▁6 ▁every ▁morning .	▁我每天 早上 6 点 叫醒 他 。
▁He ▁is ▁a ▁doctor ▁by ▁prof ess ion .	▁他的 职 业 是 医生 。
▁Everyone ▁wants ▁to ▁meet ▁you . ▁You ' re ▁famous !	▁大家都 想 见到你 , 你 太 有 名 了 !
▁He ▁has ▁a ▁lot ▁of ▁money .	▁他有 很多钱 。
▁He ▁is ▁still ▁here .	▁他 还 在这儿 。
▁When ▁are ▁you ▁going ▁home ?	▁你什么时候 要 回家 ?
▁Tom ▁should ▁have ▁plenty ▁of ▁time .	▁汤姆应该 有很多 时间 。
▁He ▁plays ▁very ▁well .	▁他 玩 得很好 。
▁Will ▁you ▁go ▁on ▁foot ▁or ▁by ▁bus ?	▁你要 用 走 的 还是 搭公车 ?
▁I ▁have ▁more ▁experience ▁than ▁Tom .	▁我 比 汤姆 更 有 经验 。
▁She ▁is ▁qu al if ied ▁as ▁a ▁nurse .	▁她是个 合 格 的 护士 。
▁My ▁father ▁is ▁in ▁the ▁habit ▁of ▁reading ▁the ▁newspaper ▁before ▁breakfast .	▁我父亲 有个 习惯 , 早餐 之前 读 报纸 。
▁Thank ▁you ▁for ▁agree ing ▁to ▁meet ▁with ▁us .	▁谢谢你 答应 来 见 我 。
▁Wait !	▁等 等 !
▁You ' ve ▁told ▁Tom , ▁haven ' t ▁you ?	▁你 告诉汤姆 了 , 没有 吗 ?
▁The ▁accident ▁happened ▁near ▁his ▁home .	▁事故 发生在 他 家 附近 。
▁I ' m ▁not ▁dis ag ree ing ▁with ▁you .	▁我没有 反对 你 。
▁I ▁thought ▁you ' d ▁be ▁full ▁after ▁eating ▁that ▁big ▁st e ak .	▁我觉得 吃完 那 块 大 牛 排 你就 饱了 。
▁Only ▁Take uch i ▁didn ' t ▁accept ▁the ▁inv itation .	▁只有 竹 内 没有 接受 邀请 。
▁I ▁found ▁the ▁book ▁interesting .	▁我觉得 这本书 很有意思 。
▁How ▁d are ▁you ▁speak ▁like ▁that ?	▁您 怎么 敢 这样 说话 ?
▁She ▁became ▁a ▁true ▁friend ▁of ▁mine .	▁她 成为 我的 一位 真正 的朋友 。
▁Let ' s ▁talk ▁about ▁this ▁tomorrow .	▁我们 来 讨论 下 明天 吧 。
▁The ▁ha w k ▁caught ▁a ▁m ouse .	▁这只 鹰 抓 到 一只 老 鼠 。
▁Where ▁are ▁you ▁going ?	▁ 哪里 出去 ?
▁T e xt ing ▁while ▁driving ▁is ▁dangerous .	▁ 开车 时 打 字 是 危险的 。
▁W hether ▁you ▁succeed ▁or ▁not ▁depends ▁on ▁your ▁own ▁eff orts .	▁你 成功 与 否 取 决 于 你 自 身 的 努力 。
▁My ▁hobby ▁is ▁making ▁mod el ▁plan es .	▁我的 嗜好 是 做 模 型 飞机 。
▁What ▁don ' t ▁you ▁want ▁us ▁to ▁see ?	▁你不 想 让我们 看见 什么 ?
▁I ' d ▁like ▁to ▁make ▁an ▁over se as ▁call .	▁我想 打 个 国际 电话 。
▁Are ▁you ▁planning ▁to ▁take ▁part ▁in ▁the ▁meeting ?	▁你们 准备 参加会议 吗 ?
▁It ▁has ▁been ▁three ▁months ▁since ▁he ▁left ▁Japan .	▁自 从 他 离开 日本 已经 有 三个月 了 。
▁I ▁want ▁to ▁cry .	▁我想 哭 。
▁Tom ▁didn ' t ▁wear ▁j e ans ▁yesterday .	▁汤姆昨天 没 穿 牛 仔 裤 。
▁I ' m ▁tired ▁of ▁him ▁b aw ling ▁me ▁out .	▁我 厌 烦 了他 对我 说 教 。
▁I ▁couldn ' t ▁find ▁it ▁anywhere .	▁我在 任何 地方 都没 能 找到 。
▁She ' s ▁not ▁a ▁child .	▁她 不是 小孩 。
▁The ▁meeting ▁has ▁almost ▁ended .	▁会议 接 近 了 尾 声 。
▁I ▁can ' t ▁b end ▁my ▁right ▁arm .	▁我无法 弯 曲 我的 右 手臂 。
▁I ▁am ▁looking ▁for ▁an ▁assist ant .	▁我正在 找 一个 助 手 。
▁Mary ▁won ' t ▁listen ▁to ▁her ▁friend ' s ▁advice .	▁玛丽 不会 听 她 朋友 的 忠告 。
▁You ▁don ' t ▁like ▁love ▁st ories , ▁do ▁you ?	▁你不 喜欢 爱 情 故事 , 是吗 ?
▁I ▁am ▁your ▁father .	▁我是 你 爸爸 。
▁Mary ▁is ▁Tom ' s ▁secret ary .	▁玛丽 是 汤姆的 秘 书 。
▁How ▁about ▁going ▁for ▁a ▁drive ?	▁去 开车 兜 风 怎样 ?
▁She ▁can ' t ▁play ▁the ▁piano ▁very ▁well .	▁她 无法 把 钢琴 弹 得很好 。
▁I ▁did ▁nothing ▁out ▁of ▁the ▁or d in ary .	▁我没 做什么 与 众 不同 的事 。
▁I ' d ▁like ▁the ▁sa u ce ▁on ▁the ▁side .	▁我想要 酱 料 放在 旁边 。
▁Everybody ▁showed ▁sy mp ath y ▁toward ▁the ▁prison er .	▁每个人都 对 囚 犯 表示 同 情 。
▁S ci ence ▁begins ▁when ▁you ▁ask ▁why ▁and ▁how .	▁ 为 何 如何 ? 你 疑问 的 当 下 就是 科学 的 开 端 。
▁I ' m ▁looking ▁for ▁my ▁pen .	▁我在 找 我的 钢笔 。
▁You ▁wouldn ' t ▁believe ▁me ▁if ▁I ▁told ▁you .	▁我 告诉你 , 你 也 不会 信 。
▁Please ▁be ▁careful ▁not ▁to ▁get ▁hurt .	▁请 小心 不要 受伤 了 。
▁My ▁mother ▁is ▁making ▁a ▁cake .	▁我的 母亲 在 做 蛋糕 。
▁I ' m ▁never ▁late ▁for ▁school .	▁我从来 没有 上学 迟到 。
▁My ▁father ▁ins ist ed ▁that ▁I ▁should ▁go ▁to ▁see ▁the ▁place .	▁我爸爸 坚持 要 我去 那 地方 看看 。
▁Did ▁anybody ▁ask ▁you ▁to ▁come ▁here ?	▁有人 叫 你来 这 吗 ?
▁I ▁was ▁already ▁tired .	▁我已经 累了 。
▁You ' ll ▁miss ▁me ▁when ▁I ' m ▁gone .	▁我 走了 你会 想 我 。
▁Every ▁time ▁I ▁read ▁the ▁B ible , ▁I ▁am ▁deep ly ▁moved .	▁每 次 我 读 圣 经 都会 被 深 深 地 感 动 。
▁She ▁was ▁very ▁proud ▁of ▁her ▁father .	▁她 非常 地 以 她 父亲 为 荣 。
▁Don ' t ▁you ▁like ▁baseball ?	▁你不 喜欢 棒球 吗 ?
▁Which ▁do ▁you ▁like ▁better , ▁spring ▁or ▁a ut um n ?	▁春天 和 秋 天 , 你 更喜欢 哪个 ?
▁It ▁is ▁less ▁hum id ▁today ▁than ▁it ▁was ▁yesterday .	▁今天 没有 昨天 潮 湿 。
▁I ' d ▁like ▁to ▁make ▁a ▁call ▁to ▁Tokyo , ▁Japan . ▁The ▁number ▁is ▁3 20 2 - 5 6 2 5.	▁我想要 打 个 电话 到 日本 东京 , 号码 是 3 20 2 - 5 6 2 5 。
▁Tom ▁didn ' t ▁know ▁what ▁Mary ▁was ▁talking ▁about .	▁汤姆不知道 玛丽 在 说 甚么 。
▁Thanks ▁for ▁your ▁rep ly .	▁谢谢 你的 答 复 。
▁What ' s ▁in ▁the ▁living ▁room ?	▁ 客 厅 里有 什么 ?
▁All ▁you ▁have ▁to ▁do ▁is ▁to ▁take ▁care ▁of ▁yourself .	▁你要 做的 只是 照顾 好 你自己 。
▁Bring ▁him ▁in .	▁ 带 他 进来 。
▁I ' ll ▁have ▁another ▁beer .	▁我会 再 喝 一杯 啤酒 。
▁I ▁owe ▁Tom ▁some ▁money .	▁我 欠 汤姆 钱 。
▁I ▁don ' t ▁mind ▁walking ▁in ▁the ▁rain .	▁我不 介意 在 雨 中 漫 步 。
▁Could ▁you ▁keep ▁this ▁l ugg age ▁until ▁3 ▁p . m . ?	▁你可以 保 管 这个 行李 直到 下午 三 点 吗 ?
▁Why ▁aren ' t ▁you ▁coming ▁with ▁us ?	▁你为什么不 和 我们 一起来 ?
▁Keep ▁your ▁mouth ▁shut ▁and ▁your ▁eyes ▁open .	▁ 闭 嘴 看着 。
▁I ' ve ▁already ▁finished ▁my ▁homework .	▁我已经 完成 了我的 作业 。
▁They ' re ▁f ake .	▁它 们 是 假 的 。
▁She ▁was ▁asked ▁to ▁write ▁her ▁name ▁in ▁in k .	▁她被 要求 用 墨 水 写 下 她的 名字 。
▁What ▁a ▁p ity ▁you ▁can ' t ▁dance !	▁ 可 惜 你 不会 跳舞 !
▁I ▁don ' t ▁want ▁to ▁swim .	▁我不想 游泳 。
▁What ▁are ▁you ▁looking ▁at ?	▁你在看什么 ?
▁They ▁aren ' t ▁afraid ▁of ▁death .	▁他们 不 怕死 。
▁Have ▁you ▁heard ▁from ▁him ?	▁你 收到 他的 音 讯 了吗 ?
▁Un fort un ately , ▁there ▁was ▁no ▁one ▁around .	▁很 不 幸 , 没有人 在 身 边 。
▁Don ' t ▁depend ▁too ▁much ▁on ▁others .	▁不要 太 过 于 依 赖 别人 。
▁Do ▁you ▁have ▁a ▁table ▁on ▁the ▁pat io ?	▁你 院 子 里有 桌子 吗 ?
▁She ▁gave ▁me ▁a ▁smile ▁of ▁recogn ition .	▁她给了我 一个 认 可 的 微笑 。
▁I ▁don ' t ▁know ▁who ▁n amed ▁this ▁dog ▁P o ch i .	▁我不知道 是谁 把 这条 狗 取 名 叫 波 奇 的 。
▁Tom ▁is ▁a ▁strange ▁person .	▁汤姆是个 怪 人 。
▁The ▁whole ▁family ▁was ▁sick ▁in ▁bed .	▁全 家都 病 倒了 。
▁A ▁change ▁of ▁air ▁will ▁do ▁you ▁a ▁lot ▁of ▁good .	▁ 改变 环 境 将 对你 有很多 好 处 。
▁They ▁smiled ▁at ▁each ▁other .	▁他们 曾 彼此 微笑 。
▁She ▁gave ▁the ▁children ▁two ▁apples ▁each .	▁她给 孩子们 每 人 两个 苹果 。
▁I ▁don ' t ▁like ▁anything .	▁我 什么都 不喜欢 。
▁She ▁may ▁have ▁missed ▁the ▁7 :00 ▁train .	▁她 可能 错过了 七点 的火车 。
▁Does n ' t ▁Tom ▁have ▁any ▁friends ?	▁汤姆没有 朋友 吗 ?
▁When ▁did ▁your ▁baby ▁start ▁talking ?	▁你的 宝宝 , 什么时候开始 说话 的 ?
▁We ▁need ▁a ▁he ro .	▁我们需要 英 雄 。
▁Your ▁memory ▁isn ' t ▁too ▁good .	▁您 记 性 不太好 。
▁Does ▁he ▁know ▁that ▁you ▁love ▁him ?	▁他 知道 你 爱 他 吗 ?
▁You ▁don ' t ▁go ▁to ▁school ▁on ▁Sunday , ▁do ▁you ?	▁你 周日 不 上学 , ▁对 吗 ?
▁What ▁does ▁this ▁stand ▁for ?	▁这是什么 意思 ?
▁I ▁heard ▁the ▁front ▁door b ell ▁ring .	▁我听到 前 门 的 门 铃 响了 。
▁To ▁make ▁matter s ▁worse , ▁it ▁began ▁snowing .	▁ 更 糟糕 的是 开始 下雪了 。
▁As ▁long ▁as ▁you ▁keep ▁quiet , ▁you ▁can ▁stay ▁here .	▁只要 你 保持安静 , ▁你可以 留 在这里 。
▁He ' s ▁three ▁years ▁older ▁than ▁me .	▁他 比我 大 三岁 。
▁I ▁don ' t ▁think ▁she ▁care s ▁very ▁much .	▁我不认为 她 很 在 意 。
▁M ut ual ▁understand ing ▁prom ot es ▁peace .	▁ 相 互 理解 能 促 进 和平 。
▁My ▁father ▁partic ip ated ▁in ▁a ▁cooking ▁cont est ▁and ▁came ▁in ▁first .	▁我爸爸 参加了 料 理 竞 赛 并 得了 第 一名 。
▁Can ▁I ▁park ▁my ▁car ▁here ?	▁我能 把我的 车 停 在这儿 吗 ?
▁I ' d ▁like ▁to ▁change ▁yen ▁to ▁dollars .	▁我想 把 日元 换 成 美元 。
▁There ' s ▁a ▁hole ▁in ▁this ▁bu cket .	▁这个 桶 子 上有个 洞 。
▁I ▁made ▁a ▁few ▁mod ific ations .	▁我 做了 点 改 动 。
▁Do ▁you ▁want ▁this ▁T - s h irt ?	▁你要 这件 T 恤 吗 ?
▁I ▁think ▁someone ' s ▁knock ing ▁on ▁the ▁door .	▁我想 有人 在 敲门 。
▁He ▁managed ▁to ▁get ▁there ▁in ▁time .	▁他 设法 及时 到达 那里 了 。
▁Here ▁we ▁are !	▁我们 到了 !
▁Mary ▁paid ▁five ▁dollars ▁for ▁her ▁lunch .	▁玛丽 用 5 美元 买了 午饭 。
▁Tom ▁asked ▁me ▁if ▁I ▁liked ▁ch ocolate .	▁汤姆 问我 是否 喜欢 巧克力 。
▁What ' s ▁your ▁name ?	▁您 叫什么名字 ?
▁Where ▁do ▁you ▁supp ose ▁you ' ll ▁spend ▁your ▁vacation ?	▁你认为 你会 到 哪儿 度假 ?
▁She ' s ▁not ▁as ▁beautiful ▁as ▁her ▁sister .	▁她不 如 她 姊 姊 漂亮 。
▁You ▁re ap ▁what ▁you ▁s ow .	▁ 种 什么 因 得 什么 果 。
▁It ' s ▁not ▁fun ny .	▁这 不好 笑 。
▁Tom ▁is ▁taller ▁than ▁his ▁mother .	▁汤姆 比 他的 母亲 高 。
▁I ▁managed ▁to ▁catch ▁the ▁last ▁train .	▁我 设法 赶 上了 最后一 班火车 。
▁I ' m ▁very ▁interested ▁in ▁j az z .	▁我对 爵 士 乐 很有 兴趣 。
▁Will ▁you ▁pick ▁me ▁up ▁at ▁seven ▁tomorrow ▁morning ?	▁你 明 早 7 点 来 接 我吗 ?
▁She ▁kept ▁crying ▁all ▁night ▁long .	▁她一 整 晚 都在 哭 。
▁He ' s ▁in ▁charge ▁of ▁the ▁dep artment .	▁他 负责 这个 部 门 。
▁He ▁broke ▁in ▁on ▁our ▁conversation .	▁他 打 断了 我们的 谈话 。
▁Somet imes ▁I ▁can ' t ▁help ▁myself .	▁有 时候 我 帮 不了 自己 。
▁She ▁was ▁always ▁qu ar re ling ▁with ▁her ▁brothers .	▁她 一直 和 她的 兄弟 争 吵 。
▁They ▁dropped ▁out ▁of ▁school .	▁他们 辍 学了 。
▁Could ▁you ▁sign ▁here ?	▁你能 在这里 签 名 吗 ?
▁Do ▁you ▁think ▁this ▁thing ▁is ▁cut e ?	▁你觉得 这个 东西 萌 吗 ?
▁I ▁had ▁a ▁slight ▁headache ▁last ▁night .	▁我昨晚 有 轻 微 的 头痛 。
▁Tom ▁has ▁lived ▁in ▁Boston ▁for ▁over ▁a ▁year .	▁汤姆 住在波士顿 已经 一年 多 了 。
▁Father ▁is ▁going ▁to ▁under g o ▁an ▁op er ation .	▁父亲 将会 接受 手 术 。
▁Tom ▁said ▁he ' d ▁be ▁willing ▁to ▁do ▁this .	▁汤姆说他 乐 意 做这事 。
▁He ▁seems ▁not ▁to ▁be ▁aw are ▁of ▁the ▁conf l ict ▁between ▁my ▁father ▁and ▁me .	▁他 似乎 不知道 我 父亲 和我 之间 的 纠 葛 。
▁My ▁can ary ▁was ▁killed ▁by ▁a ▁cat .	▁我的 金 丝 雀 被 一只 猫 杀 死了 。
▁I ▁know ▁that ▁Tom ▁is ▁hungry .	▁我知道 汤姆 饿了 。
▁I ▁got ▁the ▁information ▁from ▁him ▁dire ct ly .	▁我 直 接 从 他 那里 得到 讯 息 。
▁There ' s ▁no ▁need ▁to ▁ha il ▁a ▁taxi .	▁没 必要 叫 出租车 。
▁Put ▁away ▁your ▁books ▁and ▁note book s .	▁把你的 书 和 笔记 本 收 起来 。
▁I ▁heard ▁someone ▁call ▁my ▁name .	▁我听 见 有人 叫 我的 名字 。
▁I ▁don ' t ▁mind ▁if ▁it ' s ▁a ▁little ▁cold .	▁ 稍 微 冷 一点 没关系 。
▁Will ▁you ▁perm it ▁me ▁to ▁go ▁there ?	▁您 允许 我去 吗 ?
▁I ▁work ▁for ▁a ▁sh i pping ▁company .	▁我为 一家 船 运 公司 工作 。
▁Do ▁you ▁know ▁how ▁to ▁open ▁this ▁box ?	▁你知道 如何 打开 这个 箱子 吗 ?
▁She ▁r ides ▁a ▁mot orc ycle ▁well .	▁她 骑 摩 托车 的 技 术 不错 !
▁He ▁took ▁part ▁in ▁the ▁O ly mp ic ▁G ames .	▁他 参加了 奥 运 会 。
▁You ▁people ▁can ' t ▁help ▁your selves .	▁你们 这些 人 帮 不了 自己 。
▁M om , ▁can ▁I ▁go ▁swimming ?	▁ 妈 , 我可以 去 游泳吗 ?
▁I ' ve ▁never ▁seen ▁Tom ▁laugh .	▁我从没 见 汤姆 笑 。
▁Will ▁you ▁please ▁hold ▁this ▁ed ge ?	▁能 不能 请你 拿着 这 端 ?
▁Somet imes ▁things ▁that ▁happen ▁do ▁not ▁make ▁sense .	▁有 时候 , 发生 的事情 并 不是 合 情 合 理 的 。
▁It ▁was ▁very ▁cold ▁this ▁morning .	▁今天早上 很冷 。
▁He ▁is ▁very ▁good ▁at ▁playing ▁violin .	▁他非常 擅长 拉 小提琴 。
▁He ▁asked ▁her ▁seven ▁times ▁to ▁marry ▁him .	▁他 求 她 跟他 结婚 七 次 。
▁We ▁enjoyed ▁swimming ▁in ▁the ▁river .	▁我们喜欢 在 河里游泳 。
▁You ▁made ▁the ▁same ▁mistake ▁as ▁last ▁time .	▁你 犯了 跟 上 次 相同 的 错误 。
▁For ▁here , ▁or ▁to ▁go ?	▁ 内 用 还是 外 带 ?
▁Which ▁road ▁goes ▁to ▁city ▁ha ll ?	▁哪 条 路 通 往 市 政 厅 ?
▁Tom ' s ▁com ment ▁was ▁in app ro pri ate .	▁汤姆的 评论 不 合 适 。
▁I ' d ▁like ▁to ▁send ▁this ▁p ack age ▁to ▁Japan .	▁我想 把 这个 包 裹 寄 到 日本 。
▁When ▁I ▁came ▁home , ▁Tom ▁was ▁studying .	▁当我 回家 的时候 , 汤姆 正在 读书 。
▁She ▁made ▁a ▁point ▁of ▁visit ing ▁me .	▁她 特 地 来 拜访 我 。
▁You ▁must ▁not ▁jump ▁to ▁con cl us ions .	▁你不 可以 妄 下 结 论 。
▁What ' ll ▁you ▁be ▁doing ▁at ▁this ▁time ▁tomorrow ?	▁你明天 这个 时候 会 是在 做什么 ?
▁No ▁problem ▁at ▁all !	▁没有 任何 问题 !
▁I ▁play ▁the ▁guitar ▁after ▁dinner .	▁我 晚饭后 弹吉他 。
▁Can ▁anyone ▁believe ▁you ?	▁谁 会 相信你 ?
▁Tom ▁seems ▁to ▁be ▁easy g o ing .	▁汤姆看来 随 和 。
▁She ▁doesn ' t ▁seem ▁to ▁be ▁an ▁American .	▁她 似乎 不是 美国人 。
▁Do gs ▁have ▁a ▁ke en ▁sense ▁of ▁smell .	▁狗 的 嗅 觉 灵 敏 。
▁Tom ▁wasn ' t ▁as ▁hands ome ▁as ▁Mary ▁said ▁he ▁was .	▁汤姆 并 不是 玛丽 说得 那样 英 俊 。
▁Tom ▁explain ed ▁it ▁to ▁Mary ▁very ▁carefully .	▁汤姆 仔细 地 给玛丽 解释 。
▁They ▁wash ▁their ▁hands ▁with ▁so ap .	▁他们 用 肥 皂 洗手 。
▁I ' m ▁responsible ▁for ▁that .	▁我对 此 负 有 责任 。
▁How ▁long ▁do ▁you ▁plan ▁on ▁staying ?	▁你 准备 待多久 ?
▁He ▁came ▁to ▁see ▁you ▁yesterday .	▁他昨天 来看 你 。
▁Tom ▁didn ' t ▁have ▁enough ▁money ▁to ▁pay ▁the ▁rent .	▁汤姆没有 足够 的钱 付 租 金 。
▁Tom ▁is ▁three ▁years ▁older ▁than ▁Mary ▁is .	▁汤姆 比 玛丽 大 三岁 。
▁All ▁you ▁have ▁to ▁do ▁is ▁to ▁write ▁your ▁name ▁and ▁address ▁here .	▁你 只 要 在这里 写 下 你的 姓 名 和 地址 就 行 了 。
▁You ▁should ▁try ▁to ▁be ▁more ▁pol ite .	▁你应该 试著 更 有 礼貌 。
▁She ▁gave ▁us ▁a ▁v ag ue ▁answer .	▁她 给了我们 一个 模 糊 的 答案 。
▁We ▁got ▁an ▁interesting ▁piece ▁of ▁information .	▁我们 得到 了一 份 有趣的 情 报 。
▁The ▁plane ▁was ▁three ▁hours ▁late ▁d ue ▁to ▁bad ▁weather .	▁由于 天气 不好 , 飞机 迟到了 3 小时 。
▁Do ▁you ▁go ▁to ▁church ?	▁你 去 教堂 吗 ?
▁I ▁can ▁understand ▁him ▁perfect ly .	▁我 十分 能 理解 他 。
▁I ▁visited ▁my ▁friend ▁Tom ▁yesterday .	▁我昨天 拜访 了我的 朋友 汤姆 。
▁Call ▁home !	▁ 打电话 回家 !
▁L angu ages ▁aren ' t ▁his ▁for te .	▁ 语言 不是 他的 强 项 。
▁Our ▁c ow ▁doesn ' t ▁give ▁us ▁any ▁milk .	▁我们的 乳 牛 没有 给我们 任何 牛奶 。
▁I ▁know ▁that ▁he ▁was ▁busy .	▁我知道 他 忙 。
▁B ash o ▁was ▁the ▁great est ▁poet .	▁B ash o 是最 伟大的 诗人 。
▁Is ▁this ▁your ▁first ▁visit ▁to ▁Japan ?	▁这是你 第一次 到 日本 吗 ?
▁Don ' t ▁forget ▁to ▁take ▁out ▁the ▁gar b age .	▁别 忘了 把 垃 圾 拿 出去 。
▁I ▁managed ▁to ▁make ▁him ▁understand ▁it .	▁我 设法 让他 明白 了 。
▁You ▁look ▁like ▁a ▁little ▁girl .	▁你 看来 是个 小 女孩 。
▁Which ▁book ▁is ▁yours ?	▁哪 本书 是 你们的 ?
▁There ▁isn ' t ▁any ▁sol ution .	▁无 解 。
▁We ▁need ▁your ▁help .	▁我们需要 你的 帮忙 。
▁Tom ▁loves ▁you .	▁汤姆 爱你 。
▁It ' s ▁likely ▁to ▁rain ▁all ▁weekend .	▁可能 整个 周末 都 下雨 。
▁The ▁p ath ▁z ig z ag ged ▁up ▁the ▁st eep ▁sl ope .	▁这条 小 路 沿 著 陡 峭 的 斜 坡 蜿 蜒 而 上 。
▁Don ' t ▁ask ▁me ▁for ▁money .	▁不要 问我 要 钱 。
▁I ▁borrowed ▁Tom ' s ▁phone ▁this ▁morning .	▁我今天早上 跟 Tom 借 手机 。
▁Any thing ▁new ?	▁有 什么 新鲜 事 吗 ?
▁It ▁makes ▁sense .	▁那 样 说得 通 。
▁He ▁read ▁the ▁letter ▁over ▁and ▁over .	▁他把 信 读 了一 遍 又 一遍 。
▁I ' ll ▁be ▁there ▁at ▁once .	▁我会 立刻 到那里 。
▁I ▁think ▁I ▁may ▁have ▁made ▁a ▁big ▁mistake .	▁我认为我 可能 已经 犯了 大 错 。
▁I ▁don ' t ▁need ▁anyone .	▁我 谁 也不 需要 。
▁I ▁hate ▁ter ror ist ▁or g an iz ations .	▁我 痛 恨 恐 怖 主义 组 织 。
▁He ' s ▁very ▁f ond ▁of ▁science ▁f iction .	▁他非常 喜欢 科 幻 小说 。
▁H ard ▁work ▁and ▁d edic ation ▁will ▁bring ▁you ▁success .	▁ 努力工作 和 敬 业 精 神 使 你 成功 。
▁This ▁is ▁what ▁I ▁can ▁do ▁for ▁you .	▁这是 我能 为 您 做的 。
▁Do ▁this ▁work ▁by ▁tomorrow ▁if ▁possible .	▁如果 可能 的话 , 在 明天 前 做 好 这个工作 。
▁Were ▁you ▁serious ▁about ▁that ?	▁你对 那是 认真的 吗 ?
▁How ▁soon ▁can ▁we ▁leave ?	▁我们 过 多久 才能 离开 ?
▁We ▁don ' t ▁get ▁many ▁visit or s ▁here .	▁我们 这里 没有 很多 访 客 。
▁I ▁h ic c up ▁a ▁lot .	▁我经常 打 嗝 。
▁Tom ▁made ▁a ▁list ▁of ▁pl aces ▁he ▁wanted ▁to ▁visit .	▁汤姆 列 了他 想去 的地方 的 名 单 。
▁We ▁think ▁that ▁he ' s ▁honest .	▁我们 认为 他 诚实 。
▁There ▁was ▁no ▁water ▁in ▁the ▁well .	▁这 口 井 里 没有 水 。
▁There ' s ▁nothing ▁I ▁wouldn ' t ▁do ▁for ▁Tom .	▁没有 我不会 给汤姆 做的事 。
▁She ▁told ▁us ▁the ▁road ▁was ▁closed .	▁她 告诉我们 道 路 被 封 闭 了 。
▁Why ▁did ▁you ▁buy ▁such ▁an ▁expensive ▁dictionary ?	▁为什么你 买了一 本 那么 贵 的 词 典 ?
▁It ' s ▁ill e g al ▁to ▁park ▁your ▁car ▁here .	▁把 车 停 在这里 是 违 法 的 。
▁It ' s ▁s ort ▁of ▁strange .	▁有 点 奇怪 。
▁I ▁need ▁to ▁know ▁what ▁you ▁think .	▁我需要 知道 你 怎么想 。
▁Tom ▁was ▁very ▁sick .	▁汤姆很 虚 弱 。
▁She ▁came ▁to ▁Japan ▁for ▁the ▁purpose ▁of ▁studying ▁Japanese .	▁她 为了 学习 日 文 来 到 日本 。
▁A ▁nurse ▁took ▁my ▁temper ature .	▁一个 护士 量 了我的 体 温 。
▁Please ▁contin ue ▁with ▁your ▁story .	▁请 继续 讲 你的 故事 。
▁Tom ' s ▁eyes ight ▁is ▁det eri or ating .	▁Tom 的 视力 正在 恶 化 。
▁I ' m ▁getting ▁f ars ight ed ▁as ▁I ▁get ▁older .	▁当我 年 长 时 , 我 渐 渐 变得 有 远 见 。
▁Will ▁you ▁please ▁explain ▁the ▁meaning ▁of ▁this ▁sentence ▁to ▁me ?	▁您能 为我 解释 这 句 句子 的 意思 吗 ?
▁You ▁can ' t ▁understand ▁this ▁sentence , ▁can ▁you ?	▁你不 懂 这 句 句子 , 不是吗 ?
▁She ▁will ▁be ▁glad ▁if ▁you ▁go ▁to ▁see ▁her ▁in ▁person .	▁如果你 单 独 去看 她 , ▁她会 很高兴 的 。
▁F l ies ▁and ▁m os qu it oes ▁inter fe red ▁with ▁his ▁m ed itation .	▁ 苍 蝇 和 蚊 子 干 扰 了他的 冥 想 。
▁Un fort un ately ▁the ▁telephone ▁was ▁out ▁of ▁order .	▁不 幸 的是 电话 坏了 。
▁I ▁wish ▁Tom ▁were ▁my ▁younger ▁brother .	▁但愿 汤姆 是我的 弟弟 。
▁She ▁put ▁the ▁d irty ▁dishes ▁in ▁the ▁s ink .	▁她把 脏 盘 子 放 进 水 池 里 。
▁It ' s ▁dangerous !	▁它是 危险的 !
▁I ▁always ▁try ▁to ▁tell ▁the ▁truth .	▁我总是 试著 说 实话 。
▁I ▁had ▁a ▁good ▁dream ▁last ▁night .	▁昨晚 , 我 做了 个 好 梦 。
▁Tom ▁wouldn ' t ▁hurt ▁anyone .	▁汤姆不会 伤害 任何人 。
▁They ▁don ' t ▁like ▁me .	▁他们 不喜欢 我 。
▁Do ▁you ▁want ▁to ▁have ▁sushi ▁tonight ?	▁你 今晚 想 吃 寿司 吗 ?
▁Do ▁you ▁like ▁playing ▁v oll ey ball ?	▁你喜欢 打 排 球 吗 ?
▁Tom ▁probably ▁wanted ▁to ▁go ▁swimming .	▁汤姆可能 想去 游泳 。
▁Who ▁buy s ▁this ▁type ▁of ▁art ?	▁谁 买 这种 艺术 品 ?
▁Do ▁not ▁fear ▁the ▁un e x pect ed , ▁but ▁be ▁prepared ▁for ▁it .	▁不要 害怕 意外 , 但 要 有 准备 。
▁Please ▁drive ▁the ▁car ▁more ▁slowly .	▁请 开车 开 慢一点 。
▁F in ally , ▁it ' s ▁Fr iday .	▁ 终于 星期 五 了 。
▁She ▁left ▁the ▁hospital ▁an ▁hour ▁ago .	▁她一 小时 前 离开了 医院 。
▁We ▁don ' t ▁expect ▁Tom ▁to ▁live ▁much ▁longer .	▁我们不 指望 汤姆 能 活 得 更 久 。
▁She ▁ab and oned ▁her ▁children .	▁她 抛 弃 了她的 孩子 。
▁I ▁want ▁something ▁cold ▁to ▁drink .	▁我想 喝 冷饮 。
▁He ▁has ▁a ▁few ▁pen s .	▁他有 些 钢笔 。
▁A ▁sp ong e ▁abs or bs ▁water .	▁海 绵 吸 水 。
▁Tom ▁is ▁aw fully ▁sick .	▁汤姆 非常 虚 弱 。
▁I ▁heard ▁the ▁children ' s ▁happy ▁v o ices .	▁我听到 孩子们 开心 的声音 。
▁Dri ve ▁c aut ious ly .	▁ 开车 小心 点 。
▁That ▁was ▁the ▁first ▁time ▁that ▁a ▁man ▁walked ▁on ▁the ▁moon .	▁那是 人 类 第一次 在 月 球 上 行 走 。
▁I ▁have ▁the ▁same ▁trouble ▁as ▁you ▁have .	▁我有 跟你 同 样的 麻烦 。
▁I ▁can ' t ▁to l er ate ▁this ▁noise ▁any ▁longer .	▁我不能 再 忍受 这个 噪音 了 。
▁I ▁want ▁you ▁to ▁not ▁go ▁to ▁Boston ▁with ▁Tom .	▁我要 你 别 和汤姆 去 波士顿 。
▁I ' ve ▁got ▁to ▁go ▁to ▁the ▁bank .	▁我要 去 银行 了 。
▁This ▁is ▁a ▁good ▁book ▁for ▁children ▁to ▁read .	▁这是 本 对 儿童 好的 书 。
▁I ▁can ' t ▁eat ▁this ▁much ▁food .	▁我不能 吃 这么多 食物 。
▁How ▁do ▁you ▁feel ▁now ?	▁你现在 感觉 如何 ?
▁We ' re ▁still ▁nervous .	▁我们 还是 紧张 。
▁The ▁teacher ▁gr anted ▁me ▁perm ission ▁to ▁go ▁home ▁early .	▁老师 允许 我 提 前 回家 。
▁I ▁didn ' t ▁know ▁he ▁drank ▁so ▁much .	▁我不知道他 喝 那么多 酒 。
▁I ▁have ▁not ▁yet ▁finished ▁my ▁supper .	▁我还没 吃完 晚饭 。
▁He ▁has ▁gone ▁to ▁Hokkaido .	▁他去 北海道 了 。
▁I ▁won ' t ▁allow ▁you ▁to ▁do ▁that .	▁我不会 让你 做 那事 。
▁There ▁are ▁a ▁few ▁apples ▁on ▁the ▁tree , ▁aren ' t ▁there ?	▁ 树 上有 些 苹果 , 不是吗 ?
▁I ▁prefer ▁g ra pe f r uit s ▁to ▁oranges .	▁我喜欢 柚 子 和 橘 子 。
▁Look ▁at ▁that ▁picture ▁on ▁the ▁desk .	▁ 看看 桌 上的 那 张 相 片 。
▁I ' ll ▁let ▁Tom ▁tell ▁you .	▁我会 让汤姆 告诉你 。
▁That ' s ▁just ▁your ▁imag ination .	▁这 只是 幻 想 而 已 。
▁Please ▁knock ▁before ▁enter ing .	▁进来 之前 请 敲门 。
▁This ▁is ▁a ▁post ▁office ▁and ▁that ▁is ▁a ▁bank .	▁这是 邮局 , 那是 银行 。
▁The ▁dog ▁was ▁hit ▁by ▁a ▁truck .	▁狗 被 卡 车撞 了 。
▁It ' s ▁none ▁of ▁your ▁business .	▁这不 关 你的事 。
▁I ▁have ▁nothing ▁to ▁say ▁with ▁reg ard ▁to ▁that ▁problem .	▁对于 这个问题 我 无 可 奉 告 。
▁This ▁is ▁the ▁big gest ▁car ▁in ▁the ▁world .	▁这是 世界上 最大的 车 。
▁Tom ▁is ▁very ▁good ▁at ▁doing ▁things ▁with ▁his ▁hands .	▁汤姆 善 于 动 手 做 事 。
▁The ▁taxi ' s ▁here .	▁ 出租车 到了 。
▁I ▁kept ▁the ▁ $ 20 ▁I ▁found ▁in ▁the ▁street .	▁我 留 着 在 街 上 发现 的 20 美元 。
▁Take ▁the ▁road ▁on ▁the ▁right .	▁走 右 边 的 道 路 。
▁There ▁is ▁a ▁basket ▁under ▁the ▁table .	▁ 桌子 底下 有一个 篮 子 。
▁" W here ▁have ▁you ▁been ?" ▁" I ' ve ▁been ▁to ▁the ▁bar ber ' s ."	▁你 去哪儿 了 ? 我 去了 理发 店 。
▁You ▁are ▁old ▁enough ▁to ▁know ▁better ▁than ▁to ▁act ▁like ▁that .	▁你 够 大了 知道 不要 那样做 。
▁I ▁think ▁that ▁fact ▁is ▁very ▁important .	▁我认为 事实 非常 重要 。
▁He ▁asked ▁for ▁a ▁drink ▁of ▁water .	▁他要 了 水 喝 。
▁I ▁still ▁can ' t ▁speak ▁French .	▁我 还是 不会 说法语 。
▁We ▁left ▁home ▁early ▁in ▁the ▁morning .	▁我们 早上 很 早就 离开 家 了 。
▁We ▁can ▁do ▁more ▁than ▁they ▁can .	▁我们能 比 他们 做 得多 。
▁An ▁eye ▁for ▁an ▁eye , ▁a ▁to oth ▁for ▁a ▁to oth .	▁ 以 眼 还 眼 , 以 牙 还 牙 。
▁In ▁the ▁E d o ▁per i od , ▁moon - v iew ing ▁part ies ▁were ▁very ▁popular .	▁在 江 户 时 代 赏 月 的 宴 会 非常 受欢迎 。
▁How ' s ▁it ▁going ?	▁你们 好吗 ?
▁We ▁should ▁be ▁safe ▁here .	▁我们 在这里 应该 是 安全 的 。
▁I ▁see ▁a ▁woman ▁wearing ▁black .	▁我看见 一个 穿 黑 衣服 的女人 。
▁Could ▁you ▁please ▁speak ▁a ▁little ▁bit ▁more ▁slowly ?	▁能 否 请你 说 慢一点 ?
▁It ' s ▁a ▁real ▁bar g ain .	▁ 真是 物 美 价 廉 。
▁It ▁is ▁difficult ▁to ▁speak ▁Chinese ▁well .	▁ 很难 把 中文 说得 好 。
▁Every ▁dog ▁has ▁his ▁day .	▁ 凡 人 皆 有 得 意 时 。
▁I ' m ▁ready ▁to ▁go ▁back ▁home .	▁我 准备 回家了 。
▁He ▁painted ▁all ▁the ▁wall s ▁green .	▁他把 所有的 墙 壁 漆 成了 绿 色 。
▁I ' m ▁still ▁hungry .	▁我还 饿 着 呢 。
▁He ▁came ▁at ▁three ▁in ▁the ▁afternoon .	▁他在 下午 三 点钟 的时候 来了 。
▁The ▁boy ▁is ▁kind .	▁他 是个好 孩子 。
▁I ▁look ▁forward ▁to ▁hearing ▁from ▁you .	▁我期待 收到 你的 来信 。
▁What ▁do ▁you ▁call ▁this ▁bird ▁in ▁English ?	▁这 鸟 你们 用 英语 怎么 称 呼 ?
▁Try ▁to ▁have ▁a ▁pos it ive ▁att it ude ▁about ▁everything .	▁ 试着 用 积 极 的 态 度 去 面 对 任何 事情 。
▁Tom ▁slept ▁through ▁the ▁ent ire ▁movie .	▁汤姆在 整 场 电影 放 映 时 都在 睡觉 。
▁He ▁does ▁not ▁like ▁tennis .	▁他 不喜欢 网球 。
▁He ▁went ▁to ▁the ▁store .	▁他 去了 商店 。
▁I ' ll ▁call ▁you ▁up ▁tomorrow ▁morning .	▁明天 早上 我会 打电话 给你 。
▁He ▁used ▁to ▁m ed it ate ▁in ▁the ▁morning .	▁他 过去 时 常 在 早上 的时候 冥 想 。
▁My ▁father ▁went ▁fishing .	▁我父亲 去 钓鱼 了 。
▁Put ▁this ▁jacket ▁on , ▁and ▁you ' ll ▁be ▁much ▁war mer .	▁ 穿 上 外套 吧 ! 你会 暖 一些 。
▁You ▁have ▁to ▁come ▁with ▁me .	▁你必须 跟我 来 。
▁He ▁came ▁home ▁late ▁in ▁the ▁evening .	▁他 晚上 很晚 回家 。
▁He ▁is ▁old ▁enough ▁to ▁drive .	▁他 够 开车 的 年纪 了 。
▁Is ▁there ▁a ▁z oo ▁in ▁the ▁park ?	▁ 公园 里有 动物 园 吗 ?
▁She ▁was ▁not ▁in ▁the ▁m ood ▁for ▁lunch .	▁她 不想 吃午饭 。
▁I ▁was ▁pretty ▁hungry .	▁我 真是 饿了 。
▁After ▁you ▁have ▁read ▁it , ▁give ▁the ▁book ▁back ▁to ▁me .	▁在你 读完 后 , 把 书 还 给我 。
▁You ' d ▁better ▁start ▁now .	▁你最好 现在 就 开始 。
▁I ▁tr u ly ▁do ▁not ▁understand ▁the ▁question .	▁我真的 不懂 这个问题 。
▁I ▁was ▁just ▁trying ▁to ▁prote ct ▁you .	▁我只是 试著 保护 你 。
▁Tom ▁was ▁afraid ▁to ▁ask ▁for ▁help .	▁汤姆不 敢 求助 。
▁I ▁don ' t ▁plan ▁to ▁stay ▁for ▁very ▁long .	▁我没有 打算 停 留 太 久 。
▁Have ▁you ▁ever ▁eaten ▁Japanese ▁food ?	▁你 吃过 日本 料 理 吗 ?
▁This ▁so f a ▁takes ▁up ▁too ▁much ▁sp ace .	▁这张 沙发 占 了 太多 空 间 。
▁They ▁didn ' t ▁act ▁quickly .	▁他们 没有 立刻 行动 。
▁In ▁this ▁case , ▁the ▁ad ject ive ▁goes ▁before ▁the ▁n oun .	▁在这 种 情况 下 , 形 容 词 放在 名 词 前面 。
▁It ▁took ▁me ▁half ▁an ▁hour ▁to ▁work ▁out ▁this ▁problem .	▁我 花 了一个 半 小时 的时间 解决这个问题 。
